You are Teacup, an unusually bright and clever fox from Foxtown.  Get ready for your next adventure!

The Adventures of Teacup
Story time for Teira by Robert Haddon
Release 0 / Serial number 140113 / Inform 7 build 6G60 (I6/v6.32 lib 6/12N) SD

You groan and rub open your eyes with both paws.   You discover that you are lying near a warm and furry lump in the corner of a strange room.  You have no idea how you got here or even where "here" is.

Your last memory is of  Ralph and you starting an investigation at an old building at the edge of Foxtown.  Speaking of Ralph, where is he?

You stand up and brush yourself off.  Satisfied that you have no broken bones or open wounds, it's time to find Ralph and figure out what's happening!

>purloin boobie
[Purloined.]

>l
Small Room
This is a small room with no windows.  It is dimly lit from a grubby ceiling lamp high above your head and shines down on a dirty rug in the middle of the floor.  A doorway to the east is completely filled with a pile of rubble.

The lump that you were lying near is here, moving up and down very slightly.  It might be alive!

A dirty rug lies in the center of the room.  It's horrible looking and probably much worse to touch.  It looks quite thick and heavy, though with some help you could probably move it.

A rickety wooden desk with a single drawer sits in the northwest corner of the room.

A low, muffled sound is coming from the lump.

>i
You are carrying:
  Boobie

The lump looks strangely familiar to you now, and continues to make a low sound.

>x boobie
Boobie is not red!

The lump is nagging at your brain now, you should really check it out.

>test planting
(Testing.)

>[1] gonear underground park
Underground Park
This is a large open area stretching out in all directions as far as you can see, covered with grassy rolling hills and shallow valleys.  High above you is a bright ceiling, as if painted in light.  At the far end of this area you can see a gray rocky outcrop rising above the sea of green grass.  A trail through the grass leads off to the east.

>[2] purloin mushroom
[Purloined.]

>[3] purloin spoon
[Purloined.]

>[4] plant mushroom with spoon
Like real farmer, you create a hole in the ground with the serving spoon and put the glowing mushroom inside.

start grow timer
The lump is nagging at your brain now, you should really check it out.

>[5] 
I beg your pardon?

>l
Underground Park
This is a large open area stretching out in all directions as far as you can see, covered with grassy rolling hills and shallow valleys.  High above you is a bright ceiling, as if painted in light.  At the far end of this area you can see a gray rocky outcrop rising above the sea of green grass.  A trail through the grass leads off to the east.

A glowing fungus is lying here.

The lump is nagging at your brain now, you should really check it out.

>get mushroom
The glowing mushroom is not yet ready to be picked.

The lump is nagging at your brain now, you should really check it out.

>restart
Are you sure you want to restart?

* * *

>purloin spoon
[Purloined.]

>push lump
Looking closer at the lump, you realize it is your best friend Ralph curled up asleep!  You wake him up and he slowly comes around.
"Thank you, Teacup!" Ralph says. "What happened to us?  I don't remember anything."

>purloin mushroom
[Purloined.]

>gonear underground
Underground Park
This is a large open area stretching out in all directions as far as you can see, covered with grassy rolling hills and shallow valleys.  High above you is a bright ceiling, as if painted in light.  At the far end of this area you can see a gray rocky outcrop rising above the sea of green grass.  A trail through the grass leads off to the east.

>drop mushroom
Dropped.

>l
Underground Park
This is a large open area stretching out in all directions as far as you can see, covered with grassy rolling hills and shallow valleys.  High above you is a bright ceiling, as if painted in light.  At the far end of this area you can see a gray rocky outcrop rising above the sea of green grass.  A trail through the grass leads off to the east.

A glowing mushroom is lying here.

>get mushroom
Taken.

>actions
Actions listing on.

>z
[waiting]
Time passes.
[waiting - succeeded]

* * *

>rules
Rules tracing now switched on. Type "rules off" to switch it off again, or "rules all" to include even rules which do not apply.

>get all
[Rule "exclude people from take all rule" applies.]
[Rule "exclude fixed in place things from take all rule" applies.]
[Rule "exclude scenery from take all rule" applies.]
[Rule "exclude scenery from take all rule" applies.]
[Rule "exclude scenery from take all rule" applies.]
[Rule "exclude scenery from take all rule" applies.]
[Rule "exclude people from take all rule" applies.]
glowing mushroom: [Rule "can't take yourself rule" applies.]
[Rule "can't take other people rule" applies.]
[Rule "can't take component parts rule" applies.]
[Rule "can't take people's possessions rule" applies.]
[Rule "can't take items out of play rule" applies.]
[Rule "can't take what you're inside rule" applies.]
[Rule "can't take what's already taken rule" applies.]
[Rule "can't take scenery rule" applies.]
[Rule "can only take things rule" applies.]
[Rule "can't take what's fixed in place rule" applies.]
[Rule "use player's holdall to avoid exceeding carrying capacity rule" applies.]
[Rule "can't exceed carrying capacity rule" applies.]
[Rule "standard taking rule" applies.]
[Rule "standard report taking rule" applies.]
Taken.
peanut: [Rule "can't take yourself rule" applies.]
[Rule "can't take other people rule" applies.]
[Rule "can't take component parts rule" applies.]
[Rule "can't take people's possessions rule" applies.]
[Rule "can't take items out of play rule" applies.]
[Rule "can't take what you're inside rule" applies.]
[Rule "can't take what's already taken rule" applies.]
[Rule "can't take scenery rule" applies.]
[Rule "can only take things rule" applies.]
[Rule "can't take what's fixed in place rule" applies.]
[Rule "use player's holdall to avoid exceeding carrying capacity rule" applies.]
[Rule "can't exceed carrying capacity rule" applies.]
[Rule "standard taking rule" applies.]
[Rule "standard report taking rule" applies.]
Taken.

>z
[Rule "standard report waiting rule" applies.]
Time passes.

>z
[Rule "standard report waiting rule" applies.]
Time passes.

* * *

>get all
glowing mushroom: Taken.
peanut: Taken.

>z
Time passes.

>z
Time passes.

>rules
Rules tracing now switched on. Type "rules off" to switch it off again, or "rules all" to include even rules which do not apply.

>z
[Rule "standard report waiting rule" applies.]
Time passes.

* * *

>test mushroom-light
(Testing.)

>[1] push lump
Looking closer at the lump, you realize it is your best friend Ralph curled up asleep!  You wake him up and he slowly comes around.
"Thank you, Teacup!" Ralph says. "What happened to us?  I don't remember anything."

>[2] gonear old storage area
Old Storage Area
The stone-walled tunnel ends here, in what looks like an old storage area, based on the rotting crates lying about.

A glowing mushroom is lying here.

There are some moldy wooden storage crates here.

>[3] get mushroom
You pull the glowing mushroom out of the ground and notice that it is not quite as bright as it used to be.

>[4] z
Time passes.

Ralph arrives from the south.

>[5] z
Time passes.

>[6] z
Time passes.

>[7] z
Time passes.

>[8] z
Time passes.

The glowing mushroom seems to be getting dimmer.

>[9] z
Time passes.

>[10] z
Time passes.

>[11] z
Time passes.

>[12] z
Time passes.

>[13] z
Time passes.

>[14] z
Time passes.

Your glowing mushroom is definitely getting darker!  Perhaps you can find another one or somehow replant this one?

"That's not good," Ralph worries.

>[15] z
Time passes.

>[16] z
Time passes.

>[17] z
Time passes.

>[18] z
Time passes.

>[19] z
Time passes.

>[20] z
Time passes.

Oh no!  The mushroom is barely glowing at all now!

"We need to do something, Teacup!" Ralph warns.

>[21] z
Time passes.

>[22] z
Time passes.

>[23] z
Time passes.

>[24] z
Time passes.

>[25] z
Time passes.

>[26] z
Time passes.

The glowing mushroom has gone out!

It is now pitch dark in here!

* * *

>push lump
Looking closer at the lump, you realize it is your best friend Ralph curled up asleep!  You wake him up and he slowly comes around.
"Thank you, Teacup!" Ralph says. "What happened to us?  I don't remember anything."

>pull rug
Your snouts wrinkling in disgust, with Ralph's help you manage to slide the rug off to one side, leaving a trail of dirt and revealing a trap door in the floor!

>down
(first opening the trap door)
You and Ralph put your backs into it and apply all of your combined canine power.  There is a loud snapping sound as rusted metal and old wood give way, causing the door to fly open and you and Ralph to tumble over backwards.
The trap door is now open!

Cellar
It is cold and damp here, there is just enough light coming from the room above to see that you are in a stone-walled cellar with exits to the north and south.  This place looks ancient, possibly unused for centuries.  Green slime drips from the cracks between stones.

Green slime grows between the stone cracks here.

Ralph arrives from above.

>north
Old Storage Area
The stone-walled tunnel ends here, in what looks like an old storage area, based on the rotting crates lying about.

A glowing mushroom is lying here.

There are some moldy wooden storage crates here.

Ralph arrives from the south.

>get mushroom
You pull the glowing mushroom out of the ground and notice that it is not quite as bright as it used to be.

>s
Cellar
It is cold and damp here, there is just enough light coming from the room above to see that you are in a stone-walled cellar with exits to the north and south.  This place looks ancient, possibly unused for centuries.  Green slime drips from the cracks between stones.

Green slime grows between the stone cracks here.

Ralph arrives from the north.

>get slime
You scrape some of the stuff from between various cracks on the walls until you have enough to hold onto.  It looks greenish and unhealthy.

>x slime
It's green, it's slimey, it looks nasty, and it smells worse.

>i
You are carrying:
  a green slime
  a glowing mushroom (providing light)

Ralph is carrying the blue collar.

The glowing mushroom seems to be getting dimmer.

>s
Before you can leave, Ralph grabs your shoulder. "Teacup, listen!  Can you hear that?  Let's get out of here, now!"
You shrug your haunches and continue anyway. "What choice do we have?" You ask.

Cave-In
It is hard to say how far south the old stone-walled tunnel once led, because at the south end of the room the roof has collapsed, making the way now impassible.  

The ground is shifting under your paws and your hackles are rising:  you sense danger here!

You can see a peanut here.

Ralph arrives from the north.

>get peanut
Taken.

Boooooom!!!
The whole room begins to shake violently!  You can't tell if it is an earthquake or if a bomb has gone off somewhere near by, but you have no time to think about it as the floor on which you and Ralph are standing suddenly collapses!  You slip off your feet and tumble into a huge crack that has opened underneath you.

During your tumble, you dropped everything you were carrying!

Thick dust is falling everywhere,  preventing you from seeing anything at the moment.

Darkness
It is pitch dark, and you can't see a thing.

>z
Time passes.

The dust finally settles enough for you to see where you are.

Dining Hall
This is an elloborately decorated room with rich wood paneling on the walls and a large wooden table in the middle surrounded by fancy chairs.  The west end of the room is a mess of debris from the recent disaster, covering half the table and some of the chairs.  Hanging from the ceiling is an iron chandalier, providing light. There is a doorway to the north and a tunnel leading east.  On the west wall hangs a large tapestry.

Ralph is here beside you, ready to follow your lead.

A glowing mushroom is lying here.

You can also see a green slime and a peanut here.

>get all
glowing mushroom: Taken.
green slime: Taken.
peanut: Taken.

>n
Kitchen
You are in a medium-sized room that looks like it served as a kitchen in ages past.  It has been cleaned out.

A serving spoon is on the ground here, missed by whomever cleaned out the kitchen.

Ralph arrives from the south.

Your glowing mushroom is definitely getting darker!  Perhaps you can find another one or somehow replant this one?

"That's not good," Ralph worries.

>get spoon
Taken.

>s
Dining Hall
This is an elloborately decorated room with rich wood paneling on the walls and a large wooden table in the middle surrounded by fancy chairs.  The west end of the room is a mess of debris from the recent disaster, covering half the table and some of the chairs.  Hanging from the ceiling is an iron chandalier, providing light. There is a doorway to the north and a tunnel leading east.  On the west wall hangs a large tapestry.

Ralph arrives from the north.

>e
Underground Park
This is a large open area stretching out in all directions as far as you can see, covered with grassy rolling hills and shallow valleys.  High above you is a bright ceiling, as if painted in light.  At the far end of this area you can see a gray rocky outcrop rising above the sea of green grass.  A trail through the grass leads off to the east.

"Woah!" you exclaim, wondering what magic would allow grass to grow underground like this.

Ralph arrives from the west.

>plant mushroom with spoon
Like real farmer, you create a hole in the ground with the serving spoon and put the glowing mushroom inside.

start grow timer

>z
Time passes.

Oh no!  The mushroom is barely glowing at all now!

"We need to do something, Teacup!" Ralph warns.

>z
Time passes.

>z
Time passes.

The glowing mushroom is ready for harvest!

>get mushroom
When you pull the glowing mushroom from the ground, you realize that the magical soil here has made the glowing mushroom even better than before!

>z
Time passes.

>i
You are carrying:
  a super mushroom (providing light)
  a serving spoon
  a peanut
  a green slime

Ralph is carrying the blue collar.

>purloin slime
[Purloined.]

>plant slime with spoon
Like real farmer, you create a hole in the ground with the serving spoon and put the green slime inside.

>l
Underground Park
This is a large open area stretching out in all directions as far as you can see, covered with grassy rolling hills and shallow valleys.  High above you is a bright ceiling, as if painted in light.  At the far end of this area you can see a gray rocky outcrop rising above the sea of green grass.  A trail through the grass leads off to the east.

Disgusting green slime is growing here and spreading like a disease!

Ralph is here beside you, ready to follow your lead.

>undo
Underground Park
[Previous turn undone.]

>undo
Underground Park
[Previous turn undone.]

>i
You are carrying:
  a green slime
  a super mushroom (providing light)
  a serving spoon
  a peanut

Ralph is carrying the blue collar.

>e
Abandoned Zoo
Here you see silver cages on display, resting on raised platforms.  It looks like some sort of zoo.  Whatever creatures were here died long ago, because there are only bones in the cages now.  To the west you can see the grassy area, and on the north wall there is a doorway.

There are cages here, in which you can see some bones.

You can also see an office door here.

Ralph arrives from the west.

>plant green with spoon
This is not a good place for planting.

I beg your pardon?

>i
You are carrying:
  a green slime
  a super mushroom (providing light)
  a serving spoon
  a peanut

Ralph is carrying the blue collar.

>rules
Rules tracing now switched on. Type "rules off" to switch it off again, or "rules all" to include even rules which do not apply.

>plant green slime with spoon
[Rule "Instead of planting fungus with something in an infertile room" applies.]
This is not a good place for planting.

I beg your pardon?

>actions
Actions listing on.

>plant green slime with spoon
[planting the green slime with the serving spoon]
[Rule "Instead of planting fungus with something in an infertile room" applies.]
This is not a good place for planting.
[planting the green slime with the serving spoon - failed]

>i
[taking inventory]
[Rule "print empty inventory rule" applies.]
[Rule "print standard inventory rule" applies.]
You are carrying:
  a green slime
  a super mushroom (providing light)
  a serving spoon
  a peanut

[Rule "After taking inventory" applies.]

Ralph is carrying the blue collar.
[taking inventory - succeeded]

>x green
[examining the green slime]
[Rule "standard examining rule" applies.]
It's green, it's slimey, it looks nasty, and it smells worse.

[Rule "examine directions rule" applies.]
[Rule "examine containers rule" applies.]
[Rule "examine supporters rule" applies.]
[Rule "examine devices rule" applies.]
[Rule "examine undescribed things rule" applies.]
[Rule "report other people examining rule" applies.]
[examining the green slime - succeeded]

I beg your pardon?

>drop green
[dropping the green slime]
[Rule "can't drop yourself rule" applies.]
[Rule "can't drop what's already dropped rule" applies.]
[Rule "can't drop what's not held rule" applies.]
[Rule "can't drop clothes being worn rule" applies.]
[Rule "can't drop if this exceeds carrying capacity rule" applies.]
[Rule "standard dropping rule" applies.]
[Rule "standard report dropping rule" applies.]
Dropped.
[dropping the green slime - succeeded]

>get green
[taking the green slime]
[Rule "can't take yourself rule" applies.]
[Rule "can't take other people rule" applies.]
[Rule "can't take component parts rule" applies.]
[Rule "can't take people's possessions rule" applies.]
[Rule "can't take items out of play rule" applies.]
[Rule "can't take what you're inside rule" applies.]
[Rule "can't take what's already taken rule" applies.]
[Rule "can't take scenery rule" applies.]
[Rule "can only take things rule" applies.]
[Rule "can't take what's fixed in place rule" applies.]
[Rule "use player's holdall to avoid exceeding carrying capacity rule" applies.]
[Rule "can't exceed carrying capacity rule" applies.]
[Rule "standard taking rule" applies.]
[Rule "standard report taking rule" applies.]
Taken.
[taking the green slime - succeeded]

I beg your pardon?

>gonear cellar
[Rule "determine visibility ceiling rule" applies.]
[(1) looking]
[Rule "room description heading rule" applies.]
Cellar
[Rule "room description body text rule" applies.]
It is cold and damp here, there is just enough light coming from the room above to see that you are in a stone-walled cellar with exits to the north and south.  This place looks ancient, possibly unused for centuries.  A green shmear on the stones is evidence that slime once grew here.

[Rule "room description paragraphs about objects rule" applies.]
[Rule "don't mention player's supporter in room descriptions rule" applies.]
[Rule "don't mention scenery in room descriptions rule" applies.]
[Rule "don't mention undescribed items in room descriptions rule" applies.]
[Rule "set pronouns from items in room descriptions rule" applies.]
[Rule "offer items to writing a paragraph about rule" applies.]
[Rule "use initial appearance in room descriptions rule" applies.]
[Rule "describe what's on scenery supporters in room descriptions rule" applies.]
[Rule "don't mention player's supporter in room descriptions rule" applies.]
[Rule "don't mention scenery in room descriptions rule" applies.]
[Rule "don't mention undescribed items in room descriptions rule" applies.]
[Rule "set pronouns from items in room descriptions rule" applies.]
[Rule "offer items to writing a paragraph about rule" applies.]
[Rule "use initial appearance in room descriptions rule" applies.]
[Rule "describe what's on scenery supporters in room descriptions rule" applies.]
[Rule "check new arrival rule" applies.]
[Rule "other people looking rule" applies.]
[(1) looking - succeeded]

* * *

>push lump
Looking closer at the lump, you realize it is your best friend Ralph curled up asleep!  You wake him up and he slowly comes around.
"Thank you, Teacup!" Ralph says. "What happened to us?  I don't remember anything."

>push rug
Your snouts wrinkling in disgust, with Ralph's help you manage to slide the rug off to one side, leaving a trail of dirt and revealing a trap door in the floor!

>open door
You and Ralph put your backs into it and apply all of your combined canine power.  There is a loud snapping sound as rusted metal and old wood give way, causing the door to fly open and you and Ralph to tumble over backwards.
The trap door is now open!

>down
Cellar
It is cold and damp here, there is just enough light coming from the room above to see that you are in a stone-walled cellar with exits to the north and south.  This place looks ancient, possibly unused for centuries.  Green slime drips from the cracks between stones.

Green slime grows between the stone cracks here.

Ralph arrives from above.

>get fungus
You can't see any such thing.

>north
Old Storage Area
The stone-walled tunnel ends here, in what looks like an old storage area, based on the rotting crates lying about.

A glowing mushroom is lying here.

There are some moldy wooden storage crates here.

Ralph arrives from the south.

>get glowing mushroom
You pull the glowing mushroom out of the ground and notice that it is not quite as bright as it used to be.

>south
Cellar
It is cold and damp here, there is just enough light coming from the room above to see that you are in a stone-walled cellar with exits to the north and south.  This place looks ancient, possibly unused for centuries.  Green slime drips from the cracks between stones.

Green slime grows between the stone cracks here.

Ralph arrives from the north.

>south
Before you can leave, Ralph grabs your shoulder. "Teacup, listen!  Can you hear that?  Let's get out of here, now!"
You shrug your haunches and continue anyway. "What choice do we have?" You ask.

Cave-In
It is hard to say how far south the old stone-walled tunnel once led, because at the south end of the room the roof has collapsed, making the way now impassible.  

The ground is shifting under your paws and your hackles are rising:  you sense danger here!

You can see a peanut here.

Ralph arrives from the north.

>n
"Phew!", Ralph says with obvious relief.

Cellar
It is cold and damp here, there is just enough light coming from the room above to see that you are in a stone-walled cellar with exits to the north and south.  This place looks ancient, possibly unused for centuries.  Green slime drips from the cracks between stones.

Green slime grows between the stone cracks here.

Ralph arrives from the south.

>n
Old Storage Area
The stone-walled tunnel ends here, in what looks like an old storage area, based on the rotting crates lying about.

A glowing mushroom is lying here.

There are some moldy wooden storage crates here.

Ralph arrives from the south.

>get glowing
You pull the glowing mushroom out of the ground and notice that it is not quite as bright as it used to be.

>s
Cellar
It is cold and damp here, there is just enough light coming from the room above to see that you are in a stone-walled cellar with exits to the north and south.  This place looks ancient, possibly unused for centuries.  Green slime drips from the cracks between stones.

Green slime grows between the stone cracks here.

Ralph arrives from the north.

>s
Cave-In
It is hard to say how far south the old stone-walled tunnel once led, because at the south end of the room the roof has collapsed, making the way now impassible.  

The ground is shifting under your paws and your hackles are rising:  you sense danger here!

You can see a peanut here.

Ralph arrives from the north.

>l
Cave-In
It is hard to say how far south the old stone-walled tunnel once led, because at the south end of the room the roof has collapsed, making the way now impassible.  

The ground is shifting under your paws and your hackles are rising:  you sense danger here!

Ralph is here beside you, ready to follow your lead.

You can also see a peanut here.

>w
You can't go that way.

>z
Time passes.

>get peanut
Taken.

Boooooom!!!
The whole room begins to shake violently!  You can't tell if it is an earthquake or if a bomb has gone off somewhere near by, but you have no time to think about it as the floor on which you and Ralph are standing suddenly collapses!  You slip off your feet and tumble into a huge crack that has opened underneath you.

During your tumble, you dropped everything you were carrying!

Thick dust is falling everywhere,  preventing you from seeing anything at the moment.

Darkness
It is pitch dark, and you can't see a thing.

>z
Time passes.

The dust finally settles enough for you to see where you are.

Dining Hall
This is an elloborately decorated room with rich wood paneling on the walls and a large wooden table in the middle surrounded by fancy chairs.  The west end of the room is a mess of debris from the recent disaster, covering half the table and some of the chairs.  Hanging from the ceiling is an iron chandalier, providing light. There is a doorway to the north and a tunnel leading east.  On the west wall hangs a large tapestry.

Ralph is here beside you, ready to follow your lead.

A glowing mushroom is lying here.

You can also see a peanut here.

>get all
glowing mushroom: Taken.
peanut: Taken.

>n
Kitchen
You are in a medium-sized room that looks like it served as a kitchen in ages past.  It has been cleaned out.

A serving spoon is on the ground here, missed by whomever cleaned out the kitchen.

Ralph arrives from the south.

>get spoon
Taken.

* * *

>s
Dining Hall
This is an elloborately decorated room with rich wood paneling on the walls and a large wooden table in the middle surrounded by fancy chairs.  The west end of the room is a mess of debris from the recent disaster, covering half the table and some of the chairs.  Hanging from the ceiling is an iron chandalier, providing light. There is a doorway to the north and a tunnel leading east.  On the west wall hangs a large tapestry.

Ralph arrives from the north.

>s
You can't go that way.

>e
Underground Park
This is a large open area stretching out in all directions as far as you can see, covered with grassy rolling hills and shallow valleys.  High above you is a bright ceiling, as if painted in light.  At the far end of this area you can see a gray rocky outcrop rising above the sea of green grass.  A trail through the grass leads off to the east.

"Woah!" you exclaim, wondering what magic would allow grass to grow underground like this.

Ralph arrives from the west.

>e
Abandoned Zoo
Here you see silver cages on display, resting on raised platforms.  It looks like some sort of zoo.  Whatever creatures were here died long ago, because there are only bones in the cages now.  To the west you can see the grassy area, and on the north wall there is a doorway.

There are cages here, in which you can see some bones.

You can also see an office door here.

Ralph arrives from the west.

>n
(first opening the office door)

Zoo Office
Office of the Zoo.  There are no exits except the one you arrived by, to the south.  In one corner of the room stands an official looking desk.

There is a desk here, perhaps once used for Zoo business.

On the office desk is a cage key.

You can also see an office door and a control panel here.

Ralph arrives from the south.

>get key
Taken.

>s
Abandoned Zoo
Here you see silver cages on display, resting on raised platforms.  It looks like some sort of zoo.  Whatever creatures were here died long ago, because there are only bones in the cages now.  To the west you can see the grassy area, and on the north wall there is a doorway.

There are cages here, in which you can see some bones.

You can also see an office door here.

Ralph arrives from the north.

>unlock cage
What do you want to unlock the cage key with?

>unlock cage with key
(the cage key with the cage key)
That doesn't seem to be something you can unlock.

>unlock cages with key
You unlock the silver cages and can now get to the bones, if you wish.

>get bones
The silver cages aren't open.

>open cages
You open the silver cages.

>get bones
Taken.

>w
Underground Park
This is a large open area stretching out in all directions as far as you can see, covered with grassy rolling hills and shallow valleys.  High above you is a bright ceiling, as if painted in light.  At the far end of this area you can see a gray rocky outcrop rising above the sea of green grass.  A trail through the grass leads off to the east.

Ralph arrives from the east.

>z
Time passes.

>i
You are carrying:
  some old bones
  a serving spoon
  a peanut
  a glowing mushroom (providing light)

Ralph is carrying the blue collar.

>z
Time passes.

* * *

>south
Before you can leave, Ralph grabs your shoulder. "Teacup, listen!  Can you hear that?  Let's get out of here, now!"
You shrug your haunches and continue anyway. "What choice do we have?" You ask.

Cave-In
It is hard to say how far south the old stone-walled tunnel once led, because at the south end of the room the roof has collapsed, making the way now impassible.  

The ground is shifting under your paws and your hackles are rising:  you sense danger here!

You can see a peanut here.

Ralph arrives from the north.

>get peanut
Taken.

Boooooom!!!
The whole room begins to shake violently!  You can't tell if it is an earthquake or if a bomb has gone off somewhere near by, but you have no time to think about it as the floor on which you and Ralph are standing suddenly collapses!  You slip off your feet and tumble into a huge crack that has opened underneath you.

During your tumble, you dropped everything you were carrying!

Thick dust is falling everywhere,  preventing you from seeing anything at the moment.

Darkness
It is pitch dark, and you can't see a thing.

* * *

>rules
Rules tracing now switched on. Type "rules off" to switch it off again, or "rules all" to include even rules which do not apply.

>actions
Actions listing on.

>get mushroom
[taking the glowing mushroom]
[Rule "can't take yourself rule" applies.]
[Rule "can't take other people rule" applies.]
[Rule "can't take component parts rule" applies.]
[Rule "can't take people's possessions rule" applies.]
[Rule "can't take items out of play rule" applies.]
[Rule "can't take what you're inside rule" applies.]
[Rule "can't take what's already taken rule" applies.]
[Rule "can't take scenery rule" applies.]
[Rule "can only take things rule" applies.]
[Rule "can't take what's fixed in place rule" applies.]
[Rule "use player's holdall to avoid exceeding carrying capacity rule" applies.]
[Rule "can't exceed carrying capacity rule" applies.]
[Rule "standard taking rule" applies.]
[Rule "standard report taking rule" applies.]
Taken.
[taking the glowing mushroom - succeeded]

* * *

>gonear old storage
Old Storage Area
The stone-walled tunnel ends here, in what looks like an old storage area, based on the rotting crates lying about.

A glowing mushroom is lying here.

There are some moldy wooden storage crates here.

>rules
Rules tracing now switched on. Type "rules off" to switch it off again, or "rules all" to include even rules which do not apply.

* * *

>actions
Actions listing on.

>get glowing
[taking the glowing mushroom]
[Rule "can't take yourself rule" applies.]
[Rule "can't take other people rule" applies.]
[Rule "can't take component parts rule" applies.]
[Rule "can't take people's possessions rule" applies.]
[Rule "can't take items out of play rule" applies.]
[Rule "can't take what you're inside rule" applies.]
[Rule "can't take what's already taken rule" applies.]
[Rule "can't take scenery rule" applies.]
[Rule "can only take things rule" applies.]
[Rule "can't take what's fixed in place rule" applies.]
[Rule "use player's holdall to avoid exceeding carrying capacity rule" applies.]
[Rule "can't exceed carrying capacity rule" applies.]
[Rule "standard taking rule" applies.]
[Rule "After taking the glowing mushroom when the glowing mushroom is not handled" applies.]
[taking the glowing mushroom - succeeded]

[Rule "Every turn when Ralph is in the lump" applies.]
A low, muffled sound is coming from the lump.

>purloin ralph
[Purloined.]

>drop ralph
[dropping Ralph]
[Rule "can't drop yourself rule" applies.]
[Rule "can't drop what's already dropped rule" applies.]
[Rule "can't drop what's not held rule" applies.]
[Rule "can't drop clothes being worn rule" applies.]
[Rule "can't drop if this exceeds carrying capacity rule" applies.]
[Rule "standard dropping rule" applies.]
[Rule "standard report dropping rule" applies.]
Dropped.
[dropping Ralph - succeeded]

>i
[taking inventory]
[Rule "print empty inventory rule" applies.]
[Rule "print standard inventory rule" applies.]
You are carrying:
  a glowing mushroom (providing light)

[Rule "After taking inventory" applies.]

Ralph is carrying the blue collar.
[taking inventory - succeeded]

>gonear underground
[Rule "determine visibility ceiling rule" applies.]
[(1) looking]
[Rule "room description heading rule" applies.]
Underground Park
[Rule "room description body text rule" applies.]
This is a large open area stretching out in all directions as far as you can see, covered with grassy rolling hills and shallow valleys.  High above you is a bright ceiling, as if painted in light.  At the far end of this area you can see a gray rocky outcrop rising above the sea of green grass.  A trail through the grass leads off to the east.

[Rule "room description paragraphs about objects rule" applies.]
[Rule "don't mention player's supporter in room descriptions rule" applies.]
[Rule "don't mention scenery in room descriptions rule" applies.]
[Rule "don't mention undescribed items in room descriptions rule" applies.]
[Rule "set pronouns from items in room descriptions rule" applies.]
[Rule "offer items to writing a paragraph about rule" applies.]
[Rule "use initial appearance in room descriptions rule" applies.]
[Rule "describe what's on scenery supporters in room descriptions rule" applies.]
[Rule "don't mention player's supporter in room descriptions rule" applies.]
[Rule "don't mention scenery in room descriptions rule" applies.]
[Rule "don't mention undescribed items in room descriptions rule" applies.]
[Rule "set pronouns from items in room descriptions rule" applies.]
[Rule "offer items to writing a paragraph about rule" applies.]
[Rule "use initial appearance in room descriptions rule" applies.]
[Rule "describe what's on scenery supporters in room descriptions rule" applies.]
[Rule "check new arrival rule" applies.]
[Rule "other people looking rule" applies.]
[(1) looking - succeeded]

>purloin spoon
[Purloined.]

>l
[Rule "determine visibility ceiling rule" applies.]
[looking]
[Rule "room description heading rule" applies.]
Underground Park
[Rule "room description body text rule" applies.]
This is a large open area stretching out in all directions as far as you can see, covered with grassy rolling hills and shallow valleys.  High above you is a bright ceiling, as if painted in light.  At the far end of this area you can see a gray rocky outcrop rising above the sea of green grass.  A trail through the grass leads off to the east.

[Rule "room description paragraphs about objects rule" applies.]
[Rule "don't mention player's supporter in room descriptions rule" applies.]
[Rule "don't mention scenery in room descriptions rule" applies.]
[Rule "don't mention undescribed items in room descriptions rule" applies.]
[Rule "set pronouns from items in room descriptions rule" applies.]
[Rule "offer items to writing a paragraph about rule" applies.]
[Rule "use initial appearance in room descriptions rule" applies.]
[Rule "describe what's on scenery supporters in room descriptions rule" applies.]
[Rule "don't mention player's supporter in room descriptions rule" applies.]
[Rule "don't mention scenery in room descriptions rule" applies.]
[Rule "don't mention undescribed items in room descriptions rule" applies.]
[Rule "set pronouns from items in room descriptions rule" applies.]
[Rule "offer items to writing a paragraph about rule" applies.]
[Rule "use initial appearance in room descriptions rule" applies.]
[Rule "describe what's on scenery supporters in room descriptions rule" applies.]
[Rule "check new arrival rule" applies.]
[Rule "other people looking rule" applies.]
[looking - succeeded]

>i
[taking inventory]
[Rule "print empty inventory rule" applies.]
[Rule "print standard inventory rule" applies.]
You are carrying:
  a serving spoon
  a glowing mushroom (providing light)

[Rule "After taking inventory" applies.]

Ralph is carrying the blue collar.
[taking inventory - succeeded]

>z
[waiting]
[Rule "standard report waiting rule" applies.]
Time passes.
[waiting - succeeded]

>plant glowing with spoon
[planting the glowing mushroom with the serving spoon]
[Rule "Instead of planting fungus with something" applies.]
Like real farmer, you create a hole in the ground with the serving spoon and put the glowing mushroom inside.

[Rule "After planting the glowing mushroom with a gardening tool" applies.]
start grow timer[planting the glowing mushroom with the serving spoon - succeeded]

>i
[taking inventory]
[Rule "print empty inventory rule" applies.]
[Rule "print standard inventory rule" applies.]
You are carrying:
  a serving spoon

[Rule "After taking inventory" applies.]

Ralph is carrying the blue collar.
[taking inventory - succeeded]

>l
[Rule "determine visibility ceiling rule" applies.]
[looking]
[Rule "room description heading rule" applies.]
Underground Park
[Rule "room description body text rule" applies.]
This is a large open area stretching out in all directions as far as you can see, covered with grassy rolling hills and shallow valleys.  High above you is a bright ceiling, as if painted in light.  At the far end of this area you can see a gray rocky outcrop rising above the sea of green grass.  A trail through the grass leads off to the east.

[Rule "room description paragraphs about objects rule" applies.]
[Rule "don't mention player's supporter in room descriptions rule" applies.]
[Rule "don't mention scenery in room descriptions rule" applies.]
[Rule "don't mention undescribed items in room descriptions rule" applies.]
[Rule "set pronouns from items in room descriptions rule" applies.]
[Rule "offer items to writing a paragraph about rule" applies.]
[Rule "Rule for writing a paragraph about the planted glowing mushroom" applies.]
A glowing mushroom is growing in the ground here.

[Rule "use initial appearance in room descriptions rule" applies.]
[Rule "describe what's on scenery supporters in room descriptions rule" applies.]
[Rule "don't mention player's supporter in room descriptions rule" applies.]
[Rule "don't mention scenery in room descriptions rule" applies.]
[Rule "don't mention undescribed items in room descriptions rule" applies.]
[Rule "set pronouns from items in room descriptions rule" applies.]
[Rule "offer items to writing a paragraph about rule" applies.]
[Rule "use initial appearance in room descriptions rule" applies.]
[Rule "describe what's on scenery supporters in room descriptions rule" applies.]
[Rule "don't mention player's supporter in room descriptions rule" applies.]
[Rule "don't mention scenery in room descriptions rule" applies.]
[Rule "don't mention undescribed items in room descriptions rule" applies.]
[Rule "set pronouns from items in room descriptions rule" applies.]
[Rule "offer items to writing a paragraph about rule" applies.]
[Rule "use initial appearance in room descriptions rule" applies.]
[Rule "describe what's on scenery supporters in room descriptions rule" applies.]
[Rule "check new arrival rule" applies.]
[Rule "other people looking rule" applies.]
[looking - succeeded]

>z
[waiting]
[Rule "standard report waiting rule" applies.]
Time passes.
[waiting - succeeded]

The glowing mushroom is ready for harvest!

>showme
Underground Park - room
    glowing mushroom - Fungus
    yourself - person
        serving spoon - gardening tool
    large rock formation
        chisled steps (part of large rock formation)

>get glowing
[taking the glowing mushroom]
[Rule "Instead of taking planted glowing mushroom" applies.]
When you pull the glowing mushroom from the ground, you realize that the magical soil here has made the glowing mushroom even better than before!
[taking the glowing mushroom - failed]

>i
[taking inventory]
[Rule "print empty inventory rule" applies.]
[Rule "print standard inventory rule" applies.]
You are carrying:
  a super mushroom (providing light)
  a serving spoon

[Rule "After taking inventory" applies.]

Ralph is carrying the blue collar.
[taking inventory - succeeded]

>z
[waiting]
[Rule "standard report waiting rule" applies.]
Time passes.
[waiting - succeeded]

>z
[waiting]
[Rule "standard report waiting rule" applies.]
Time passes.
[waiting - succeeded]

>i
[taking inventory]
[Rule "print empty inventory rule" applies.]
[Rule "print standard inventory rule" applies.]
You are carrying:
  a super mushroom (providing light)
  a serving spoon

[Rule "After taking inventory" applies.]

Ralph is carrying the blue collar.
[taking inventory - succeeded]

* * *

>z
[waiting]
[Rule "standard report waiting rule" applies.]
Time passes.
[waiting - succeeded]

>g
[waiting]
[Rule "standard report waiting rule" applies.]
Time passes.
[waiting - succeeded]

>g
[waiting]
[Rule "standard report waiting rule" applies.]
Time passes.
[waiting - succeeded]

>showme
Underground Park - room
    yourself - person
        super mushroom - Fungus
        serving spoon - gardening tool
    large rock formation
        chisled steps (part of large rock formation)

>i
[taking inventory]
[Rule "print empty inventory rule" applies.]
[Rule "print standard inventory rule" applies.]
You are carrying:
  a super mushroom (providing light)
  a serving spoon

[Rule "After taking inventory" applies.]

Ralph is carrying the blue collar.
[taking inventory - succeeded]

* * *

>l
Small Room
This is a small room with no windows.  It is dimly lit from a grubby ceiling lamp high above your head and shines down on a dirty rug in the middle of the floor.  A doorway to the east is completely filled with a pile of rubble.

The lump that you were lying near is here, moving up and down very slightly.  It might be alive!

A dirty rug lies in the center of the room.  It's horrible looking and probably much worse to touch.  It looks quite thick and heavy, though with some help you could probably move it.

A rickety wooden desk with a single drawer sits in the northwest corner of the room.

A low, muffled sound is coming from the lump.

>x
What do you want to examine?

>x lump
Looking closer at the lump, you realize it is your best friend Ralph curled up asleep!  You wake him up and he slowly comes around.
"Thank you, Teacup!" Ralph says. "What happened to us?  I don't remember anything."

>examine ralph
Ralph is a young wolf with light gray fur and wearing a blue collar.  He's been your friend and trusty companion on more adventures than you can count on with all four paws.

>g
Ralph is a young wolf with light gray fur and wearing a blue collar.  He's been your friend and trusty companion on more adventures than you can count on with all four paws.

>open drawer
You open the drawer, revealing a leather bound book.

>get book
Taken.

>read book
This is a beautiful leather bound book entitled "The Adventures of Teacup, Episode 1".
You flip to the first page and start reading: "You are Teacup, an unusually bright and clever fox from Foxtown..."

Before you can read further, a voice speaks out of nowhere and scolds you for cheating!
The book vanishes into thin air!

Ralph shrugs "Well, it was worth a try."

>i
You are carrying nothing.

Ralph is carrying the blue collar.

* * *

>test
>--> The following tests are available:
'test planting'
'test mushroom-light'
'test ralph-poison'
'test giving'
'test Earthquake'
'test parklights'

>test mushroom-light
(Testing.)

>[1] gonear old storage area
Old Storage Area
The stone-walled tunnel ends here, in what looks like an old storage area, based on the rotting crates lying about.

A glowing mushroom is lying here.

There are some moldy wooden storage crates here.

>[2] get mushroom
You pull the glowing mushroom out of the ground and notice that it is not quite as bright as it used to be.

A low, muffled sound is coming from the lump.

>[3] z
Time passes.

The lump looks strangely familiar to you now, and continues to make a low sound.

>[4] z
Time passes.

The lump is nagging at your brain now, you should really check it out.

>[5] z
Time passes.

The lump is nagging at your brain now, you should really check it out.

>[6] z
Time passes.

The lump is nagging at your brain now, you should really check it out.

>[7] z
Time passes.

The lump is nagging at your brain now, you should really check it out.

The glowing mushroom seems to be getting dimmer.

>[8] z
Time passes.

The lump is nagging at your brain now, you should really check it out.

>[9] z
Time passes.

The lump is nagging at your brain now, you should really check it out.

>[10] z
Time passes.

The lump is nagging at your brain now, you should really check it out.

>[11] z
Time passes.

The lump is nagging at your brain now, you should really check it out.

>[12] z
Time passes.

The lump is nagging at your brain now, you should really check it out.

>[13] z
Time passes.

The lump is nagging at your brain now, you should really check it out.

Your glowing mushroom is definitely getting darker!  Perhaps you can find another one or somehow replant this one?

>[14] z
Time passes.

The lump is nagging at your brain now, you should really check it out.

>[15] z
Time passes.

The lump is nagging at your brain now, you should really check it out.

>[16] z
Time passes.

The lump is nagging at your brain now, you should really check it out.

>[17] z
Time passes.

The lump is nagging at your brain now, you should really check it out.

>[18] z
Time passes.

The lump is nagging at your brain now, you should really check it out.

>[19] z
Time passes.

The lump is nagging at your brain now, you should really check it out.

Oh no!  The mushroom is barely glowing at all now!

>[20] z
Time passes.

The lump is nagging at your brain now, you should really check it out.

>[21] z
Time passes.

The lump is nagging at your brain now, you should really check it out.

>[22] z
Time passes.

The lump is nagging at your brain now, you should really check it out.

>[23] z
Time passes.

The lump is nagging at your brain now, you should really check it out.

>[24] z
Time passes.

The lump is nagging at your brain now, you should really check it out.

>[25] z
Time passes.

The lump is nagging at your brain now, you should really check it out.

The glowing mushroom has gone out!

It is now pitch dark in here!

>i
You are carrying:
  a glowing mushroom

The lump is nagging at your brain now, you should really check it out.

* * *

>test planting
(Testing.)

>[1] gonear underground park
Underground Park
This is a large open area stretching out in all directions as far as you can see, covered with grassy rolling hills and shallow valleys.  High above you is a bright ceiling, as if painted in light.  At the far end of this area you can see a gray rocky outcrop rising above the sea of green grass.  A trail through the grass leads off to the east.

>[2] purloin mushroom
[Purloined.]

>[3] purloin spoon
[Purloined.]

>[4] plant mushroom with spoon
Like real farmer, you create a hole in the ground with the serving spoon and put the glowing mushroom inside.

start grow timer
A low, muffled sound is coming from the lump.

>[5] 
I beg your pardon?

>l
Underground Park
This is a large open area stretching out in all directions as far as you can see, covered with grassy rolling hills and shallow valleys.  High above you is a bright ceiling, as if painted in light.  At the far end of this area you can see a gray rocky outcrop rising above the sea of green grass.  A trail through the grass leads off to the east.

A glowing mushroom is growing in the ground here.

The lump looks strangely familiar to you now, and continues to make a low sound.

>get mushroom
The glowing mushroom is not yet ready to be picked.

The lump is nagging at your brain now, you should really check it out.

>z
Time passes.

The lump is nagging at your brain now, you should really check it out.

The glowing mushroom is ready for harvest!

>showme
Underground Park - room
    glowing mushroom - Fungus
    yourself - person
        serving spoon - gardening tool
    large rock formation
        chisled steps (part of large rock formation)

>get mushroom
The glowing mushroom is not yet ready to be picked.

The lump is nagging at your brain now, you should really check it out.

* * *

>purloin mushroom
[Purloined.]

>l
Small Room
This is a small room with no windows.  It is dimly lit from a grubby ceiling lamp high above your head and shines down on a dirty rug in the middle of the floor.  A doorway to the east is completely filled with a pile of rubble.

The lump that you were lying near is here, moving up and down very slightly.  It might be alive!

A dirty rug lies in the center of the room.  It's horrible looking and probably much worse to touch.  It looks quite thick and heavy, though with some help you could probably move it.

A rickety wooden desk with a single drawer sits in the northwest corner of the room.

A low, muffled sound is coming from the lump.

>drop mushroom
Dropped.

The lump looks strangely familiar to you now, and continues to make a low sound.

>l
Small Room
This is a small room with no windows.  It is dimly lit from a grubby ceiling lamp high above your head and shines down on a dirty rug in the middle of the floor.  A doorway to the east is completely filled with a pile of rubble.

nothing is lying here.

The lump that you were lying near is here, moving up and down very slightly.  It might be alive!

A dirty rug lies in the center of the room.  It's horrible looking and probably much worse to touch.  It looks quite thick and heavy, though with some help you could probably move it.

A rickety wooden desk with a single drawer sits in the northwest corner of the room.

The lump is nagging at your brain now, you should really check it out.

>rules
Rules tracing now switched on. Type "rules off" to switch it off again, or "rules all" to include even rules which do not apply.

* * *

>push lump. pull rug. down. north
Looking closer at the lump, you realize it is your best friend Ralph curled up asleep!  You wake him up and he slowly comes around.
"Thank you, Teacup!" Ralph says. "What happened to us?  I don't remember anything."

Your snouts wrinkling in disgust, with Ralph's help you manage to slide the rug off to one side, leaving a trail of dirt and revealing a trap door in the floor!

(first opening the trap door)
You and Ralph put your backs into it and apply all of your combined canine power.  There is a loud snapping sound as rusted metal and old wood give way, causing the door to fly open and you and Ralph to tumble over backwards.
The trap door is now open!

Cellar
It is cold and damp here, there is just enough light coming from the room above to see that you are in a stone-walled cellar with exits to the north and south.  This place looks ancient, possibly unused for centuries.

Green slime drips from the cracks between stones.

Ralph arrives from above.

Old Storage Area
The stone-walled tunnel ends here, in what looks like an old storage area, based on the rotting crates lying about.

A glowing mushroom is lying here.

There are some moldy wooden storage crates here.

Ralph arrives from the south.

>rules
Rules tracing now switched on. Type "rules off" to switch it off again, or "rules all" to include even rules which do not apply.

* * *

>actions
Actions listing on.

>rules all
Rules tracing now switched to "all". Type "rules off" to switch it off again.

>rules off
[Rule "standard set going variables rule" does not apply.]
[Rule "determine visibility ceiling rule" does not apply.]
[Rule "Setting action variables for exiting" does not apply.]
Rules tracing now switched off. Type "rules" to switch it on again.

>rules
Rules tracing now switched on. Type "rules off" to switch it off again, or "rules all" to include even rules which do not apply.

>l
[Rule "determine visibility ceiling rule" applies.]
[looking]
[Rule "room description heading rule" applies.]
Old Storage Area
[Rule "room description body text rule" applies.]
The stone-walled tunnel ends here, in what looks like an old storage area, based on the rotting crates lying about.

[Rule "room description paragraphs about objects rule" applies.]
[Rule "don't mention player's supporter in room descriptions rule" applies.]
[Rule "don't mention scenery in room descriptions rule" applies.]
[Rule "don't mention undescribed items in room descriptions rule" applies.]
[Rule "set pronouns from items in room descriptions rule" applies.]
[Rule "offer items to writing a paragraph about rule" applies.]
[Rule "use initial appearance in room descriptions rule" applies.]
Ralph is here beside you, ready to follow your lead.

[Rule "describe what's on scenery supporters in room descriptions rule" applies.]
[Rule "don't mention player's supporter in room descriptions rule" applies.]
[Rule "don't mention scenery in room descriptions rule" applies.]
[Rule "don't mention undescribed items in room descriptions rule" applies.]
[Rule "set pronouns from items in room descriptions rule" applies.]
[Rule "offer items to writing a paragraph about rule" applies.]
[Rule "use initial appearance in room descriptions rule" applies.]
[Rule "describe what's on scenery supporters in room descriptions rule" applies.]
[Rule "don't mention player's supporter in room descriptions rule" applies.]
[Rule "don't mention scenery in room descriptions rule" applies.]
[Rule "don't mention undescribed items in room descriptions rule" applies.]
[Rule "set pronouns from items in room descriptions rule" applies.]
[Rule "offer items to writing a paragraph about rule" applies.]
[Rule "Rule for writing a paragraph about the loose glowing mushroom" applies.]
A glowing mushroom is lying here.

[Rule "use initial appearance in room descriptions rule" applies.]
[Rule "describe what's on scenery supporters in room descriptions rule" applies.]
[Rule "don't mention player's supporter in room descriptions rule" applies.]
[Rule "don't mention scenery in room descriptions rule" applies.]
[Rule "don't mention undescribed items in room descriptions rule" applies.]
[Rule "set pronouns from items in room descriptions rule" applies.]
[Rule "offer items to writing a paragraph about rule" applies.]
[Rule "use initial appearance in room descriptions rule" applies.]
There are some moldy wooden storage crates here.

[Rule "describe what's on scenery supporters in room descriptions rule" applies.]
[Rule "check new arrival rule" applies.]
[Rule "other people looking rule" applies.]
[looking - succeeded]

>get mushroom
[taking the glowing mushroom]
[Rule "can't take yourself rule" applies.]
[Rule "can't take other people rule" applies.]
[Rule "can't take component parts rule" applies.]
[Rule "can't take people's possessions rule" applies.]
[Rule "can't take items out of play rule" applies.]
[Rule "can't take what you're inside rule" applies.]
[Rule "can't take what's already taken rule" applies.]
[Rule "can't take scenery rule" applies.]
[Rule "can only take things rule" applies.]
[Rule "can't take what's fixed in place rule" applies.]
[Rule "use player's holdall to avoid exceeding carrying capacity rule" applies.]
[Rule "can't exceed carrying capacity rule" applies.]
[Rule "standard taking rule" applies.]
[Rule "After taking the glowing mushroom when the glowing mushroom is not handled" applies.]
[taking the glowing mushroom - succeeded]

>z
[waiting]
[Rule "standard report waiting rule" applies.]
Time passes.
[waiting - succeeded]