You are Teacup, an unusually bright and clever fox from Foxtown.  Get ready for your next adventure!

The Adventures of Teacup
Story time for Teira by Robert Haddon
Release 0 / Serial number 140114 / Inform 7 build 6G60 (I6/v6.32 lib 6/12N) SD

You groan and rub open your eyes with both paws.   You discover that you are lying near a warm and furry lump in the corner of a strange room.  You have no idea how you got here or even where "here" is.

Your last memory is of  Ralph and you starting an investigation at an old building at the edge of Foxtown.  Speaking of Ralph, where is he?

You stand up and brush yourself off.  Satisfied that you have no broken bones or open wounds, it's time to find Ralph and figure out what's happening!

>push lump
Looking closer at the lump, you realize it is your best friend Ralph curled up asleep!  You wake him up and he slowly comes around.
"Thank you, Teacup!" Ralph says. "What happened to us?  I don't remember anything."

>gonear storage
Old Storage Area
The stone-walled tunnel ends here, in what looks like an old storage area, based on the rotting crates lying about.

A glowing mushroom is here.

There are some moldy wooden storage crates here.

>get mushroom
You pull the glowing mushroom out of the ground and notice that it is not quite as bright as it used to be.

>gonear zoo office
Zoo Office
Office of the Zoo.  There are no exits except the one you arrived by, to the south.  In one corner of the room stands an official looking desk.

There is a desk here, perhaps once used for Zoo business.

On the office desk is a cage key.

You can also see an office door and a control panel here.

>purloin spoon
[Purloined.]

>l
Zoo Office
Office of the Zoo.  There are no exits except the one you arrived by, to the south.  In one corner of the room stands an official looking desk.

There is a desk here, perhaps once used for Zoo business.

On the office desk is a cage key.

You can also see an office door and a control panel here.

>purloin ralph
[Purloined.]

>drop ralph
Dropped.

>push button
Click.

growing period timer starts

>s
(first opening the office door)

Abandoned Zoo
Here you see silver cages on display, resting on raised platforms.  It looks like some sort of zoo.  Whatever creatures were here died long ago, because there are only bones in the cages now.  To the west you can see the grassy area, and on the north wall there is a doorway.

There are cages here, in which you can see some bones.

You can also see an office door here.

Ralph arrives from the north.

>w
Underground Park
This is a large open area stretching out in all directions as far as you can see, covered with grassy rolling hills and shallow valleys.  High above you is a bright ceiling, as if painted in light.  At the far end of this area you can see a gray rocky outcrop rising above the sea of green grass.  A trail through the grass leads off to the east.

"Woah!" you exclaim, wondering what magic would allow grass to grow underground like this.

Ralph arrives from the east.

>plant mushroom with spoon
Like real farmer, you create a hole in the ground with the serving spoon and put the glowing mushroom inside.

start grow timer
It is now pitch dark in here!

>l
Darkness
It is pitch dark, and you can't see a thing.

>z
Time passes.

"Let's check on the glowing mushroom we planted!" Ralph eagerly suggests.

>l
Darkness
It is pitch dark, and you can't see a thing.

Underground Park
This is a large open area stretching out in all directions as far as you can see, covered with grassy rolling hills and shallow valleys.  High above you is a bright ceiling, as if painted in light.  At the far end of this area you can see a gray rocky outcrop rising above the sea of green grass.  A trail through the grass leads off to the east.

You can see a super mushroom (providing light) and Ralph here.

>z
Time passes.

* * *

>gonear zoo office
Zoo Office
Office of the Zoo.  There are no exits except the one you arrived by, to the south.  In one corner of the room stands an official looking desk.

There is a desk here, perhaps once used for Zoo business.

On the office desk is a cage key.

You can also see an office door and a control panel here.

>purloin green slime
[Purloined.]

>purloin spoon
[Purloined.]

>s
(first opening the office door)

Abandoned Zoo
Here you see silver cages on display, resting on raised platforms.  It looks like some sort of zoo.  Whatever creatures were here died long ago, because there are only bones in the cages now.  To the west you can see the grassy area, and on the north wall there is a doorway.

There are cages here, in which you can see some bones.

You can also see an office door here.

>w
Underground Park
This is a large open area stretching out in all directions as far as you can see, covered with grassy rolling hills and shallow valleys.  High above you is a bright ceiling, as if painted in light.  At the far end of this area you can see a gray rocky outcrop rising above the sea of green grass.  A trail through the grass leads off to the east.

"Woah!" you exclaim, wondering what magic would allow grass to grow underground like this.

>plant mushroom with spoon
Like real farmer, you create a hole in the ground with the serving spoon and put the glowing mushroom inside.

start grow timer
"try darkness"

>z
Time passes.

"try darkness"

>z
Time passes.

"try darkness"

>z
Time passes.

>l
Underground Park
This is a large open area stretching out in all directions as far as you can see, covered with grassy rolling hills and shallow valleys.  High above you is a bright ceiling, as if painted in light.  At the far end of this area you can see a gray rocky outcrop rising above the sea of green grass.  A trail through the grass leads off to the east.

You can see a super mushroom here.

* * *

>purloin spoon
[Purloined.]

>purloin ralph
[Purloined.]

* * *

>drop ralph
Dropped.

>s
(first opening the office door)

Abandoned Zoo
Here you see silver cages on display, resting on raised platforms.  It looks like some sort of zoo.  Whatever creatures were here died long ago, because there are only bones in the cages now.  To the west you can see the grassy area, and on the north wall there is a doorway.

There are cages here, in which you can see some bones.

You can also see an office door here.

Ralph arrives from the north.

>w
Underground Park
This is a large open area stretching out in all directions as far as you can see, covered with grassy rolling hills and shallow valleys.  High above you is a bright ceiling, as if painted in light.  At the far end of this area you can see a gray rocky outcrop rising above the sea of green grass.  A trail through the grass leads off to the east.

"Woah!" you exclaim, wondering what magic would allow grass to grow underground like this.

Ralph arrives from the east.

The glowing mushroom seems to be getting dimmer.

>plant mushroom with spoon
Like real farmer, you create a hole in the ground with the serving spoon and put the glowing mushroom inside.

"I'm not a gardener, Teacup, but I think fungi like the glowing mushroom only grow in the dark." Ralph tells you.

>get mushroom
The glowing mushroom is not yet ready to be picked.

"Maybe there's a way to turn off the lights in the park"

>ralph, get mushroom
The glowing mushroom is not yet ready to be picked.

Ralph is unable to do that.

>ralph, get mushroom
The glowing mushroom is not yet ready to be picked.

Ralph is unable to do that.

>plant mushroom with spoon
Like real farmer, you create a hole in the ground with the serving spoon and put the glowing mushroom inside.

>ralph, get mushroom
The glowing mushroom is not yet ready to be picked.

Ralph is unable to do that.

>l
Underground Park
This is a large open area stretching out in all directions as far as you can see, covered with grassy rolling hills and shallow valleys.  High above you is a bright ceiling, as if painted in light.  At the far end of this area you can see a gray rocky outcrop rising above the sea of green grass.  A trail through the grass leads off to the east.

A glowing mushroom is growing in the ground here.

You can also see Ralph here.

>get mushroom
The glowing mushroom is not yet ready to be picked.

>undo
Underground Park
[Previous turn undone.]

>i
You are carrying:
  a serving spoon
  a green slime

Ralph is carrying the blue collar.

>undo
Underground Park
[Previous turn undone.]

>l
Underground Park
This is a large open area stretching out in all directions as far as you can see, covered with grassy rolling hills and shallow valleys.  High above you is a bright ceiling, as if painted in light.  At the far end of this area you can see a gray rocky outcrop rising above the sea of green grass.  A trail through the grass leads off to the east.

A glowing mushroom is growing in the ground here.

You can also see Ralph here.

>undo
Underground Park
[Previous turn undone.]

* * *

>l
Underground Park
This is a large open area stretching out in all directions as far as you can see, covered with grassy rolling hills and shallow valleys.  High above you is a bright ceiling, as if painted in light.  At the far end of this area you can see a gray rocky outcrop rising above the sea of green grass.  A trail through the grass leads off to the east.

A glowing mushroom is growing in the ground here.

You can also see Ralph here.

>i
You are carrying:
  a serving spoon
  a green slime

Ralph is carrying the blue collar.

>plant mushroom with spoon
Like real farmer, you create a hole in the ground with the serving spoon and put the glowing mushroom inside.

>get mushroom
The glowing mushroom is not yet ready to be picked.

* * *

>undo
Underground Park
[Previous turn undone.]

>rules
Rules tracing now switched on. Type "rules off" to switch it off again, or "rules all" to include even rules which do not apply.

>get mushroom
[Rule "Instead of the player taking planted fungus" applies.]
The glowing mushroom is not yet ready to be picked.

>undo
Underground Park
[Previous turn undone.]

>ralph, take mushroom
[Rule "Persuasion rule for asking Ralph to try taking something" applies.]
[Rule "Instead of anyone taking planted fungus" applies.]
The glowing mushroom is not yet ready to be picked.

Ralph is unable to do that.

>z
[Rule "standard report waiting rule" applies.]
Time passes.

>ralph, take mushroom
[Rule "Persuasion rule for asking Ralph to try taking something" applies.]
[Rule "Instead of anyone taking planted fungus" applies.]
The glowing mushroom is not yet ready to be picked.

Ralph is unable to do that.

>ralph, take mushroom
[Rule "Persuasion rule for asking Ralph to try taking something" applies.]
[Rule "Instead of anyone taking planted fungus" applies.]
The glowing mushroom is not yet ready to be picked.

Ralph is unable to do that.

>rules
Rules tracing now switched on. Type "rules off" to switch it off again, or "rules all" to include even rules which do not apply.

* * *

>get mushroom
[Rule "Instead of the player taking planted fungus" applies.]
The glowing mushroom is not yet ready to be picked.

>ralph, get mushroom
[Rule "Persuasion rule for asking Ralph to try taking something" applies.]
[Rule "Instead of anyone taking planted fungus" applies.]
The glowing mushroom is not yet ready to be picked.

Ralph is unable to do that.

* * *

I beg your pardon?

>rules off
Rules tracing now switched off. Type "rules" to switch it on again.

>n
Zoo Office
Office of the Zoo.  There are no exits except the one you arrived by, to the south.  In one corner of the room stands an official looking desk.

There is a desk here, perhaps once used for Zoo business.

On the office desk is a cage key.

You can also see an office door and a control panel here.

Ralph arrives from the south.

>push button
Click.

"I think this will work!" Ralph tells you.

>s
Abandoned Zoo
Here you see silver cages on display, resting on raised platforms.  It looks like some sort of zoo.  Whatever creatures were here died long ago, because there are only bones in the cages now.  To the west you can see the grassy area, and on the north wall there is a doorway.

There are cages here, in which you can see some bones.

You can also see an office door here.

Ralph arrives from the north.

>w
Darkness
It is pitch dark, and you can't see a thing.

Underground Park
This is a large open area stretching out in all directions as far as you can see, covered with grassy rolling hills and shallow valleys.  High above you is a bright ceiling, as if painted in light.  At the far end of this area you can see a gray rocky outcrop rising above the sea of green grass.  A trail through the grass leads off to the east.

A glowing mushroom is lying here.

You can also see Ralph here.

>ralph, get mushroom
Ralph picks up the glowing mushroom.

>l
Underground Park
This is a large open area stretching out in all directions as far as you can see, covered with grassy rolling hills and shallow valleys.  High above you is a bright ceiling, as if painted in light.  At the far end of this area you can see a gray rocky outcrop rising above the sea of green grass.  A trail through the grass leads off to the east.

You can see Ralph here.

>undo
Underground Park
[Previous turn undone.]

>l
Underground Park
This is a large open area stretching out in all directions as far as you can see, covered with grassy rolling hills and shallow valleys.  High above you is a bright ceiling, as if painted in light.  At the far end of this area you can see a gray rocky outcrop rising above the sea of green grass.  A trail through the grass leads off to the east.

A glowing mushroom is lying here.

You can also see Ralph here.

>x glowing
You see nothing special about the glowing mushroom.

>showme
Underground Park - room
    Ralph - wolf
        blue collar (worn)
    yourself - person
        serving spoon - gardening tool
        green slime - Fungus
    glowing mushroom - Fungus
    large rock formation
        chisled steps (part of large rock formation)

>z
Time passes.

>e
Abandoned Zoo
Here you see silver cages on display, resting on raised platforms.  It looks like some sort of zoo.  Whatever creatures were here died long ago, because there are only bones in the cages now.  To the west you can see the grassy area, and on the north wall there is a doorway.

There are cages here, in which you can see some bones.

You can also see an office door here.

Ralph arrives from the west.

>n
Zoo Office
Office of the Zoo.  There are no exits except the one you arrived by, to the south.  In one corner of the room stands an official looking desk.

There is a desk here, perhaps once used for Zoo business.

On the office desk is a cage key.

You can also see an office door and a control panel here.

Ralph arrives from the south.

>push button
Click.

>s
Abandoned Zoo
Here you see silver cages on display, resting on raised platforms.  It looks like some sort of zoo.  Whatever creatures were here died long ago, because there are only bones in the cages now.  To the west you can see the grassy area, and on the north wall there is a doorway.

There are cages here, in which you can see some bones.

You can also see an office door here.

Ralph arrives from the north.

>w
Underground Park
This is a large open area stretching out in all directions as far as you can see, covered with grassy rolling hills and shallow valleys.  High above you is a bright ceiling, as if painted in light.  At the far end of this area you can see a gray rocky outcrop rising above the sea of green grass.  A trail through the grass leads off to the east.

A glowing mushroom is lying here.

Ralph arrives from the east.

>get mushroom
Taken.

* * *

>plant mushroom with spoon
Like real farmer, you create a hole in the ground with the serving spoon and put the glowing mushroom inside.

"I'm not a gardener, Teacup, but I think fungi like the glowing mushroom only grow in the dark." Ralph tells you.

>z
Time passes.

"I'm not a gardener, Teacup, but I think fungi like the glowing mushroom only grow in the dark." Ralph tells you.

>z
Time passes.

"I'm not a gardener, Teacup, but I think fungi like the glowing mushroom only grow in the dark." Ralph tells you.

>e
Abandoned Zoo
Here you see silver cages on display, resting on raised platforms.  It looks like some sort of zoo.  Whatever creatures were here died long ago, because there are only bones in the cages now.  To the west you can see the grassy area, and on the north wall there is a doorway.

There are cages here, in which you can see some bones.

You can also see an office door here.

Ralph arrives from the west.

"I'm not a gardener, Teacup, but I think fungi like the glowing mushroom only grow in the dark." Ralph tells you.

>n
Zoo Office
Office of the Zoo.  There are no exits except the one you arrived by, to the south.  In one corner of the room stands an official looking desk.

There is a desk here, perhaps once used for Zoo business.

On the office desk is a cage key.

You can also see an office door and a control panel here.

Ralph arrives from the south.

"I'm not a gardener, Teacup, but I think fungi like the glowing mushroom only grow in the dark." Ralph tells you.

>push button
Click.

* * *

>s
Abandoned Zoo
Here you see silver cages on display, resting on raised platforms.  It looks like some sort of zoo.  Whatever creatures were here died long ago, because there are only bones in the cages now.  To the west you can see the grassy area, and on the north wall there is a doorway.

There are cages here, in which you can see some bones.

You can also see an office door here.

Ralph arrives from the north.

>w
Darkness
It is pitch dark, and you can't see a thing.

>z
Time passes.

>l
Darkness
It is pitch dark, and you can't see a thing.

>z
Time passes.

* * *

>plant mushroom with spoon
Like real farmer, you create a hole in the ground with the serving spoon and put the glowing mushroom inside.

"I'm not a gardener, Teacup, but I think fungi like the glowing mushroom only grow in the dark." Ralph tells you.

>e
Abandoned Zoo
Here you see silver cages on display, resting on raised platforms.  It looks like some sort of zoo.  Whatever creatures were here died long ago, because there are only bones in the cages now.  To the west you can see the grassy area, and on the north wall there is a doorway.

There are cages here, in which you can see some bones.

You can also see an office door here.

Ralph arrives from the west.

"I'm not a gardener, Teacup, but I think fungi like the glowing mushroom only grow in the dark." Ralph tells you.

* * *

>n
Zoo Office
Office of the Zoo.  There are no exits except the one you arrived by, to the south.  In one corner of the room stands an official looking desk.

There is a desk here, perhaps once used for Zoo business.

On the office desk is a cage key.

You can also see an office door and a control panel here.

Ralph arrives from the south.

"I'm not a gardener, Teacup, but I think fungi like the glowing mushroom only grow in the dark." Ralph tells you.

>push button
Click.

"I think this will work!" Ralph tells you.

* * *

>s
Abandoned Zoo
Here you see silver cages on display, resting on raised platforms.  It looks like some sort of zoo.  Whatever creatures were here died long ago, because there are only bones in the cages now.  To the west you can see the grassy area, and on the north wall there is a doorway.

There are cages here, in which you can see some bones.

You can also see an office door here.

Ralph arrives from the north.

>w
Darkness
It is pitch dark, and you can't see a thing.

Underground Park
This is a large open area stretching out in all directions as far as you can see, covered with grassy rolling hills and shallow valleys.  High above you is a bright ceiling, as if painted in light.  At the far end of this area you can see a gray rocky outcrop rising above the sea of green grass.  A trail through the grass leads off to the east.

You can see a super mushroom (providing light) and Ralph here.

>z
Time passes.

* * *

>w
Darkness
It is pitch dark, and you can't see a thing.

Underground Park
This is a large open area stretching out in all directions as far as you can see, covered with grassy rolling hills and shallow valleys.  High above you is a bright ceiling, as if painted in light.  At the far end of this area you can see a gray rocky outcrop rising above the sea of green grass.  A trail through the grass leads off to the east.

You can see a super mushroom (providing light) and Ralph here.

>showme
Underground Park - room
    super mushroom - Fungus
    Ralph - wolf
        blue collar (worn)
    yourself - person
        serving spoon - gardening tool
        green slime - Fungus
    large rock formation
        chisled steps (part of large rock formation)

>z
Time passes.

***logic booboo

>showme
Underground Park - room
    *Ralph - wolf
        *blue collar (worn)
    yourself - person
        serving spoon - gardening tool
        green slime - Fungus
    *glowing mushroom - Fungus
    *large rock formation
        *chisled steps (part of large rock formation)
* denotes things which are not in scope

>z
Time passes.

***logic booboo

>z
Time passes.

***logic booboo

* * *

>push button
Click.

"I think this will work!" Ralph tells you.

I beg your pardon?

* * *

>push button
Click.

"I think this will work!" Ralph tells you.

>z
Time passes.

***the glowing mushroom in the Underground Park is in darkness

>showme
Zoo Office - room
    Ralph - wolf
        blue collar (worn)
    office door - open door
    yourself - person
        serving spoon - gardening tool
        green slime - Fungus
    control panel
        green button (part of control panel) - switch
    office desk - Furniture
        small top drawer (part of office desk) - closed container
        large side drawer (part of office desk) - locked container
            *zoo record book
        cage key
* denotes things which are not in scope

>z
Time passes.

***the glowing mushroom in the Underground Park is in darkness

***The glowing mushroom is ready for harvest!

>z
Time passes.

* * *

>plant mushroom with spoon
Like real farmer, you create a hole in the ground with the serving spoon and put the glowing mushroom inside.

"I'm not a gardener, Teacup, but I think fungi like the glowing mushroom only grow in the dark." Ralph tells you.

>rules
Rules tracing now switched on. Type "rules off" to switch it off again, or "rules all" to include even rules which do not apply.

* * *

>push button
[Rule "Instead of pushing the green button" applies.]
Click.

* * *

I beg your pardon?

>w
[Rule "standard set going variables rule" applies.]
[Rule "can't travel in what's not a vehicle rule" applies.]
[Rule "can't go through undescribed doors rule" applies.]
[Rule "can't go through closed doors rule" applies.]
[Rule "determine map connection rule" applies.]
[Rule "can't go that way rule" applies.]
[Rule "move player and vehicle rule" applies.]
[Rule "move floating objects rule" applies.]
[Rule "check light in new location rule" applies.]
[Rule "describe room gone into rule" applies.]

[Rule "determine visibility ceiling rule" applies.]
[Rule "room description heading rule" applies.]
Darkness
[Rule "room description body text rule" applies.]
It is pitch dark, and you can't see a thing.

[Rule "room description paragraphs about objects rule" applies.]
[Rule "check new arrival rule" applies.]
[Rule "other people looking rule" applies.]
[Rule "standard set going variables rule" applies.]
[Rule "can't travel in what's not a vehicle rule" applies.]
[Rule "can't go through undescribed doors rule" applies.]
[Rule "can't go through closed doors rule" applies.]
[Rule "determine map connection rule" applies.]
[Rule "can't go that way rule" applies.]
[Rule "move player and vehicle rule" applies.]
[Rule "move floating objects rule" applies.]
[Rule "check light in new location rule" applies.]

>showme
Underground Park - room
    *Ralph - wolf
        *blue collar (worn)
    yourself - person
        serving spoon - gardening tool
        green slime - Fungus
    *glowing mushroom - Fungus
    *large rock formation
        *chisled steps (part of large rock formation)
* denotes things which are not in scope

>z
[Rule "standard report waiting rule" applies.]
Time passes.

>l
[Rule "determine visibility ceiling rule" applies.]
[Rule "room description heading rule" applies.]
Darkness
[Rule "room description body text rule" applies.]
It is pitch dark, and you can't see a thing.

[Rule "room description paragraphs about objects rule" applies.]
[Rule "check new arrival rule" applies.]
[Rule "other people looking rule" applies.]

>showme
Underground Park - room
    *Ralph - wolf
        *blue collar (worn)
    yourself - person
        serving spoon - gardening tool
        green slime - Fungus
    *glowing mushroom - Fungus
    *large rock formation
        *chisled steps (part of large rock formation)
* denotes things which are not in scope

* * *

>plant mushroom with spoon
Like real farmer, you create a hole in the ground with the serving spoon and put the glowing mushroom inside.

"I'm not a gardener, Teacup, but I think fungi like the glowing mushroom only grow in the dark." Ralph tells you.

>l
Underground Park
This is a large open area stretching out in all directions as far as you can see, covered with grassy rolling hills and shallow valleys.  High above you is a bright ceiling, as if painted in light.  At the far end of this area you can see a gray rocky outcrop rising above the sea of green grass.  A trail through the grass leads off to the east.

A glowing mushroom is growing in the ground here.

You can also see Ralph here.

"Maybe there's a way to turn off the lights in the park"

>x glowing
The glowing mushroom is planted in the ground; there's not much to see.

>rules
Rules tracing now switched on. Type "rules off" to switch it off again, or "rules all" to include even rules which do not apply.

>x glowing
[Rule "Instead of examining fungus" applies.]
The glowing mushroom is planted in the ground; there's not much to see.

>l
[Rule "determine visibility ceiling rule" applies.]
[Rule "room description heading rule" applies.]
Underground Park
[Rule "room description body text rule" applies.]
This is a large open area stretching out in all directions as far as you can see, covered with grassy rolling hills and shallow valleys.  High above you is a bright ceiling, as if painted in light.  At the far end of this area you can see a gray rocky outcrop rising above the sea of green grass.  A trail through the grass leads off to the east.

[Rule "room description paragraphs about objects rule" applies.]
[Rule "don't mention player's supporter in room descriptions rule" applies.]
[Rule "don't mention scenery in room descriptions rule" applies.]
[Rule "don't mention undescribed items in room descriptions rule" applies.]
[Rule "set pronouns from items in room descriptions rule" applies.]
[Rule "offer items to writing a paragraph about rule" applies.]
[Rule "Rule for writing a paragraph about the planted glowing mushroom" applies.]
A glowing mushroom is growing in the ground here.

[Rule "use initial appearance in room descriptions rule" applies.]
[Rule "describe what's on scenery supporters in room descriptions rule" applies.]
[Rule "don't mention player's supporter in room descriptions rule" applies.]
[Rule "don't mention scenery in room descriptions rule" applies.]
[Rule "don't mention undescribed items in room descriptions rule" applies.]
[Rule "set pronouns from items in room descriptions rule" applies.]
[Rule "offer items to writing a paragraph about rule" applies.]
[Rule "use initial appearance in room descriptions rule" applies.]
[Rule "describe what's on scenery supporters in room descriptions rule" applies.]
[Rule "don't mention player's supporter in room descriptions rule" applies.]
[Rule "don't mention scenery in room descriptions rule" applies.]
[Rule "don't mention undescribed items in room descriptions rule" applies.]
[Rule "set pronouns from items in room descriptions rule" applies.]
[Rule "offer items to writing a paragraph about rule" applies.]
[Rule "use initial appearance in room descriptions rule" applies.]
[Rule "describe what's on scenery supporters in room descriptions rule" applies.]
[Rule "don't mention player's supporter in room descriptions rule" applies.]
[Rule "don't mention scenery in room descriptions rule" applies.]
[Rule "don't mention undescribed items in room descriptions rule" applies.]
[Rule "set pronouns from items in room descriptions rule" applies.]
[Rule "offer items to writing a paragraph about rule" applies.]
[Rule "use initial appearance in room descriptions rule" applies.]
[Rule "describe what's on scenery supporters in room descriptions rule" applies.]
You can also see Ralph here.

[Rule "check new arrival rule" applies.]
[Rule "other people looking rule" applies.]

I beg your pardon?

* * *

>rules off
Rules tracing now switched off. Type "rules" to switch it on again.

>x glowing
You can't see any such thing.

>w
Underground Park
This is a large open area stretching out in all directions as far as you can see, covered with grassy rolling hills and shallow valleys.  High above you is a bright ceiling, as if painted in light.  At the far end of this area you can see a gray rocky outcrop rising above the sea of green grass.  A trail through the grass leads off to the east.

A glowing mushroom is growing in the ground here.

Ralph arrives from the east.

>x glowing
The glowing mushroom is planted in the ground; there's not much to see.

>e
Abandoned Zoo
Here you see silver cages on display, resting on raised platforms.  It looks like some sort of zoo.  Whatever creatures were here died long ago, because there are only bones in the cages now.  To the west you can see the grassy area, and on the north wall there is a doorway.

There are cages here, in which you can see some bones.

You can also see an office door here.

Ralph arrives from the west.

* * *

>w
Darkness
It is pitch dark, and you can't see a thing.

Underground Park
This is a large open area stretching out in all directions as far as you can see, covered with grassy rolling hills and shallow valleys.  High above you is a bright ceiling, as if painted in light.  At the far end of this area you can see a gray rocky outcrop rising above the sea of green grass.  A trail through the grass leads off to the east.

A glowing mushroom is lying here.

You can also see Ralph here.

>x glowing
You see nothing special about the glowing mushroom.

* * *

>w
Underground Park
This is a large open area stretching out in all directions as far as you can see, covered with grassy rolling hills and shallow valleys.  High above you is a bright ceiling, as if painted in light.  At the far end of this area you can see a gray rocky outcrop rising above the sea of green grass.  A trail through the grass leads off to the east.

"Woah!" you exclaim, wondering what magic would allow grass to grow underground like this.

Ralph arrives from the east.

The glowing mushroom seems to be getting dimmer.

>e
Abandoned Zoo
Here you see silver cages on display, resting on raised platforms.  It looks like some sort of zoo.  Whatever creatures were here died long ago, because there are only bones in the cages now.  To the west you can see the grassy area, and on the north wall there is a doorway.

There are cages here, in which you can see some bones.

You can also see an office door here.

Ralph arrives from the west.

* * *

>push button
Click.

>z
Time passes.

Your glowing mushroom is definitely getting darker!  Perhaps you can find another one or somehow replant this one?

"That's not good," Ralph worries.

>z
Time passes.

>z
Time passes.

Oh no!  The mushroom is barely glowing at all now!

"We need to do something, Teacup!" Ralph warns.

>s
Abandoned Zoo
Here you see silver cages on display, resting on raised platforms.  It looks like some sort of zoo.  Whatever creatures were here died long ago, because there are only bones in the cages now.  To the west you can see the grassy area, and on the north wall there is a doorway.

There are cages here, in which you can see some bones.

You can also see an office door here.

Ralph arrives from the north.

>w
Underground Park
This is a large open area stretching out in all directions as far as you can see, covered with grassy rolling hills and shallow valleys.  High above you is a bright ceiling, as if painted in light.  At the far end of this area you can see a gray rocky outcrop rising above the sea of green grass.  A trail through the grass leads off to the east.

Ralph arrives from the east.

>e
Abandoned Zoo
Here you see silver cages on display, resting on raised platforms.  It looks like some sort of zoo.  Whatever creatures were here died long ago, because there are only bones in the cages now.  To the west you can see the grassy area, and on the north wall there is a doorway.

There are cages here, in which you can see some bones.

You can also see an office door here.

Ralph arrives from the west.

* * *

>push button
Click.

>s
Abandoned Zoo
Here you see silver cages on display, resting on raised platforms.  It looks like some sort of zoo.  Whatever creatures were here died long ago, because there are only bones in the cages now.  To the west you can see the grassy area, and on the north wall there is a doorway.

There are cages here, in which you can see some bones.

You can also see an office door here.

Ralph arrives from the north.

The glowing mushroom has gone out!

>w
Underground Park
This is a large open area stretching out in all directions as far as you can see, covered with grassy rolling hills and shallow valleys.  High above you is a bright ceiling, as if painted in light.  At the far end of this area you can see a gray rocky outcrop rising above the sea of green grass.  A trail through the grass leads off to the east.

Ralph arrives from the east.

>i
You are carrying:
  a serving spoon
  a green slime
  a glowing mushroom

Ralph is carrying the blue collar.

>plant glowing with spoon
Like real farmer, you create a hole in the ground with the serving spoon and put the glowing mushroom inside.

"I'm not a gardener, Teacup, but I think fungi like the glowing mushroom only grow in the dark." Ralph tells you.

>e
Abandoned Zoo
Here you see silver cages on display, resting on raised platforms.  It looks like some sort of zoo.  Whatever creatures were here died long ago, because there are only bones in the cages now.  To the west you can see the grassy area, and on the north wall there is a doorway.

There are cages here, in which you can see some bones.

You can also see an office door here.

Ralph arrives from the west.

"Maybe there's a way to turn off the lights in the park"

>n
Zoo Office
Office of the Zoo.  There are no exits except the one you arrived by, to the south.  In one corner of the room stands an official looking desk.

There is a desk here, perhaps once used for Zoo business.

On the office desk is a cage key.

You can also see an office door and a control panel here.

Ralph arrives from the south.

* * *

>s
Abandoned Zoo
Here you see silver cages on display, resting on raised platforms.  It looks like some sort of zoo.  Whatever creatures were here died long ago, because there are only bones in the cages now.  To the west you can see the grassy area, and on the north wall there is a doorway.

There are cages here, in which you can see some bones.

You can also see an office door here.

Ralph arrives from the north.

>w
Darkness
It is pitch dark, and you can't see a thing.

Underground Park
This is a large open area stretching out in all directions as far as you can see, covered with grassy rolling hills and shallow valleys.  High above you is a bright ceiling, as if painted in light.  At the far end of this area you can see a gray rocky outcrop rising above the sea of green grass.  A trail through the grass leads off to the east.

A glowing mushroom is growing in the ground here.

You can also see Ralph here.

>get mushroom
When you harvest the glowing mushroom, it seems brighter than before.

Taken.

>showme
Underground Park - room
    Ralph - wolf
        blue collar (worn)
    yourself - person
        glowing mushroom - Fungus
        serving spoon - gardening tool
        green slime - Fungus
    large rock formation
        chisled steps (part of large rock formation)

>i
You are carrying:
  a glowing mushroom (providing light)
  a serving spoon
  a green slime

Ralph is carrying the blue collar.

* * *

>push button
Click.

"I think this will work!" Ralph tells you.

>gonear park
Darkness
It is pitch dark, and you can't see a thing.

>undo
Zoo Office
[Previous turn undone.]

>push button
Click.

>gonear park
Underground Park
This is a large open area stretching out in all directions as far as you can see, covered with grassy rolling hills and shallow valleys.  High above you is a bright ceiling, as if painted in light.  At the far end of this area you can see a gray rocky outcrop rising above the sea of green grass.  A trail through the grass leads off to the east.

A glowing mushroom is growing in the ground here.

>get mushroom
The glowing mushroom is not yet ready to be picked.

"You remember something from your research that mushrooms like to grow in the dark."

>s
You can't go that way.

Ralph arrives from the east.

>e
Abandoned Zoo
Here you see silver cages on display, resting on raised platforms.  It looks like some sort of zoo.  Whatever creatures were here died long ago, because there are only bones in the cages now.  To the west you can see the grassy area, and on the north wall there is a doorway.

There are cages here, in which you can see some bones.

You can also see an office door here.

Ralph arrives from the west.

* * *

>gonear park
Underground Park
This is a large open area stretching out in all directions as far as you can see, covered with grassy rolling hills and shallow valleys.  High above you is a bright ceiling, as if painted in light.  At the far end of this area you can see a gray rocky outcrop rising above the sea of green grass.  A trail through the grass leads off to the east.

A glowing mushroom is growing in the ground here.

>get mushroom
When you harvest the glowing mushroom, it seems brighter than before.

Taken.

>i
You are carrying:
  a glowing mushroom (providing light)
  a serving spoon
  a green slime

Ralph is carrying the blue collar.

Ralph arrives from the east.

>undo
Underground Park
[Previous turn undone.]

>ralph, get mushroom
You seem to want to talk to someone, but I can't see whom.

>showme
Underground Park - room
    yourself - person
        serving spoon - gardening tool
        green slime - Fungus
    glowing mushroom - Fungus
    large rock formation
        chisled steps (part of large rock formation)

>undo
Underground Park
[Previous turn undone.]

>purloin ralph
[Purloined.]

>get mushroom
When you harvest the glowing mushroom, it seems brighter than before.

Taken.

* * *

>purloin ralph
[Purloined.]

>ralph, get mushroom
Ralph picks up the glowing mushroom.

>l
Underground Park
This is a large open area stretching out in all directions as far as you can see, covered with grassy rolling hills and shallow valleys.  High above you is a bright ceiling, as if painted in light.  At the far end of this area you can see a gray rocky outcrop rising above the sea of green grass.  A trail through the grass leads off to the east.

>i
You are carrying:
  Ralph
  a serving spoon
  a green slime

Ralph is carrying the glowing mushroom and the blue collar.

>e
Abandoned Zoo
Here you see silver cages on display, resting on raised platforms.  It looks like some sort of zoo.  Whatever creatures were here died long ago, because there are only bones in the cages now.  To the west you can see the grassy area, and on the north wall there is a doorway.

There are cages here, in which you can see some bones.

You can also see an office door here.

"You remember something from your research that mushrooms like to grow in the dark."

>i
You are carrying:
  Ralph
  a serving spoon
  a green slime

Ralph is carrying the glowing mushroom and the blue collar.

"You remember something from your research that mushrooms like to grow in the dark."

I beg your pardon?

>l
Abandoned Zoo
Here you see silver cages on display, resting on raised platforms.  It looks like some sort of zoo.  Whatever creatures were here died long ago, because there are only bones in the cages now.  To the west you can see the grassy area, and on the north wall there is a doorway.

There are cages here, in which you can see some bones.

You can also see an office door here.

"You remember something from your research that mushrooms like to grow in the dark."

>undo
Abandoned Zoo
[Previous turn undone.]

>undo
Abandoned Zoo
[Previous turn undone.]

* * *

>w
Underground Park
This is a large open area stretching out in all directions as far as you can see, covered with grassy rolling hills and shallow valleys.  High above you is a bright ceiling, as if painted in light.  At the far end of this area you can see a gray rocky outcrop rising above the sea of green grass.  A trail through the grass leads off to the east.

"Woah!" you exclaim, wondering what magic would allow grass to grow underground like this.

Ralph arrives from the east.

The glowing mushroom seems to be getting dimmer.

>z
Time passes.

>z
Time passes.

Your glowing mushroom is definitely getting darker!  Perhaps you can find another one or somehow replant this one?

"That's not good," Ralph worries.

* * *

>z
Time passes.

>z
Time passes.

The glowing mushroom has gone out!

>z
Time passes.

>i
You are carrying:
  a serving spoon
  a green slime
  a glowing mushroom

Ralph is carrying the blue collar.

>e
Abandoned Zoo
Here you see silver cages on display, resting on raised platforms.  It looks like some sort of zoo.  Whatever creatures were here died long ago, because there are only bones in the cages now.  To the west you can see the grassy area, and on the north wall there is a doorway.

There are cages here, in which you can see some bones.

You can also see an office door here.

Ralph arrives from the west.

* * *

>w
Darkness
It is pitch dark, and you can't see a thing.

>plant mushroom with spoon
Like real farmer, you create a hole in the ground with the serving spoon and put the glowing mushroom inside.

"I think this will work!" Ralph tells you.

>x glowing
You can't see any such thing.

>z
Time passes.

>z
Time passes.

Underground Park
This is a large open area stretching out in all directions as far as you can see, covered with grassy rolling hills and shallow valleys.  High above you is a bright ceiling, as if painted in light.  At the far end of this area you can see a gray rocky outcrop rising above the sea of green grass.  A trail through the grass leads off to the east.

A glowing mushroom is here.

You can also see Ralph here.

>get mushroom
Taken.

>l
Underground Park
This is a large open area stretching out in all directions as far as you can see, covered with grassy rolling hills and shallow valleys.  High above you is a bright ceiling, as if painted in light.  At the far end of this area you can see a gray rocky outcrop rising above the sea of green grass.  A trail through the grass leads off to the east.

You can see Ralph here.

>x mushroom
You see nothing special about the glowing mushroom.

* * *

>get mushroom
You pull the glowing mushroom out of the ground and notice that it is not quite as bright as it used to be.

>gonear underground park
Underground Park
This is a large open area stretching out in all directions as far as you can see, covered with grassy rolling hills and shallow valleys.  High above you is a bright ceiling, as if painted in light.  At the far end of this area you can see a gray rocky outcrop rising above the sea of green grass.  A trail through the grass leads off to the east.

>e
Abandoned Zoo
Here you see silver cages on display, resting on raised platforms.  It looks like some sort of zoo.  Whatever creatures were here died long ago, because there are only bones in the cages now.  To the west you can see the grassy area, and on the north wall there is a doorway.

There are cages here, in which you can see some bones.

You can also see an office door here.

>n
(first opening the office door)

Zoo Office
Office of the Zoo.  There are no exits except the one you arrived by, to the south.  In one corner of the room stands an official looking desk.

There is a desk here, perhaps once used for Zoo business.

On the office desk is a cage key.

You can also see an office door and a control panel here.

>push button
Click.

growing period timer starts

>purloin spoon
[Purloined.]

>s
Abandoned Zoo
Here you see silver cages on display, resting on raised platforms.  It looks like some sort of zoo.  Whatever creatures were here died long ago, because there are only bones in the cages now.  To the west you can see the grassy area, and on the north wall there is a doorway.

There are cages here, in which you can see some bones.

You can also see an office door here.

>w
Underground Park
This is a large open area stretching out in all directions as far as you can see, covered with grassy rolling hills and shallow valleys.  High above you is a bright ceiling, as if painted in light.  At the far end of this area you can see a gray rocky outcrop rising above the sea of green grass.  A trail through the grass leads off to the east.

"Woah!" you exclaim, wondering what magic would allow grass to grow underground like this.

>plant mushroom with spoon
Like real farmer, you create a hole in the ground with the serving spoon and put the glowing mushroom inside.

start grow timer
*The glowing mushroom is planted in the dark.*
It is now pitch dark in here!

>z
Time passes.

*The glowing mushroom is planted in the dark.*

>z
Time passes.

*The glowing mushroom is planted in the dark.*You think the glowing mushroom might be ready to pluck.

>z
Time passes.

*The glowing mushroom is planted in the dark.*You think the glowing mushroom might be ready to pluck.

The glowing mushroom is ready for harvest!

Underground Park
This is a large open area stretching out in all directions as far as you can see, covered with grassy rolling hills and shallow valleys.  High above you is a bright ceiling, as if painted in light.  At the far end of this area you can see a gray rocky outcrop rising above the sea of green grass.  A trail through the grass leads off to the east.

You can see a super mushroom (providing light) here.