You are Teacup, an unusually bright and clever fox from Foxtown.

You groan and rub open your eyes with both paws.   You discover that you are lying near a warm and furry lump in the corner of a strange room.  You have no idea how you got here or even where "here" is.  It's time to find some answers, Teacup!

The Adventures of Teacup, Episode 1
Story time for Teira by Robert Haddon
Release 0 / Serial number 140105 / Inform 7 build 6G60 (I6/v6.32 lib 6/12N) SD

Small Room
This is a small room with no windows.  It is dimly lit from a grubby ceiling lamp high above your head and shines down on a dirty rug in the middle of the floor.  A doorway to the east is completely filled with a pile of rubble.

A dirty rug lies in the center of the room.  It's quite hideous to look at and probably much worse to touch.  It looks quite thick and heavy

A rickety wooden desk with a single drawer sits in the northwest corner of the room.

The lump that you were lying near is here, moving up and down very slightly.  It might be alive!

>w
You can't go that way.

A low, muffled sound is coming from the lump.

* * *

>x warm lump
Looking closer at the lump, you realize it is your best friend Ralph curled up asleep!  You wake him up and he slowly comes around.
Ralph says, "Thank you, Teacup!  What happened to us?  I don't remember anything."

>restart
Are you sure you want to restart?

* * *

>wait
Time passes.

A low, muffled sound is coming from the lump.

>push lump
Looking closer at the lump, you realize it is your best friend Ralph curled up asleep!  You wake him up and he slowly comes around.
Ralph says, "Thank you, Teacup!  What happened to us?  I don't remember anything."

"Hey, I'm bored," Ralph says. "Let's go for a ramble."

* * *

>x furry
Looking closer at the lump, you realize it is your best friend Ralph curled up asleep!  You wake him up and he slowly comes around.
Ralph says, "Thank you, Teacup!  What happened to us?  I don't remember anything."

* * *

>x ralph
Where is Ralph?  It would be great if your best friend were here to help you.

A low, muffled sound is coming from the lump.

>push lump
Looking closer at the lump, you realize it is your best friend Ralph curled up asleep!  You wake him up and he slowly comes around.
Ralph says, "Thank you, Teacup!  What happened to us?  I don't remember anything."

>x ralph
Ralph is a young wolf with light gray fur.  He's been your friend and trusty companion with you on more adventures than you can count on with all four paws.

>restart
Are you sure you want to restart?

* * *

>d
You can't go that way.

A low, muffled sound is coming from the lump.

>push lump
Looking closer at the lump, you realize it is your best friend Ralph curled up asleep!  You wake him up and he slowly comes around.
Ralph says, "Thank you, Teacup!  What happened to us?  I don't remember anything."

>x friend
Ralph is a young wolf with light gray fur.  He's been your friend and trusty companion with you on more adventures than you can count on with all four paws.

>x wolf
Ralph is a young wolf with light gray fur.  He's been your friend and trusty companion with you on more adventures than you can count on with all four paws.

>look at ralph
Ralph is a young wolf with light gray fur.  He's been your friend and trusty companion with you on more adventures than you can count on with all four paws.

>x ralph
Ralph is a young wolf with light gray fur.  He's been your friend and trusty companion with you on more adventures than you can count on with all four paws.

* * *

>pull rug
It's no use; the rug is too heavy and grimy to move it by yourself.

A low, muffled sound is coming from the lump.

>move rug
It's no use; the rug is too heavy and grimy to move it by yourself.

The lump looks strangely familiar to you now, and continues to make a low sound.

>pull rug
It's no use; the rug is too heavy and grimy to move it by yourself.

The lump looks strangely familiar to you now, and continues to make a low sound.

>push lump
Looking closer at the lump, you realize it is your best friend Ralph curled up asleep!  You wake him up and he slowly comes around.
Ralph says, "Thank you, Teacup!  What happened to us?  I don't remember anything."

>pull rug
Your snouts wrinkling in disgust, you and Ralph manage to slide the rug off to one side, leaving a trail of dirt and revealing a trap door in the floor!

* * *

>pull lump
Looking closer at the lump, you realize it is your best friend Ralph curled up asleep!  You wake him up and he slowly comes around.
Ralph says, "Thank you, Teacup!  What happened to us?  I don't remember anything."

>grap rug
That's not a verb I recognize.

>get rug
The rug is too large and heavy to pickup, not to mention filthy.

>pull rug
Your snouts wrinkling in disgust, you and Ralph manage to slide the rug off to one side, leaving a trail of dirt and revealing a trap door in the floor!

>pull rug
You've already moved the filthy rug once.  It's so gross you don't want to touch it again

* * *

>push the filthy
It's no use; the rug is too heavy and grimy to move it by yourself.

A low, muffled sound is coming from the lump.

>push the dirty rug
It's no use; the rug is too heavy and grimy to move it by yourself.

The lump looks strangely familiar to you now, and continues to make a low sound.

>pull the filthy rug
It's no use; the rug is too heavy and grimy to move it by yourself.

The lump looks strangely familiar to you now, and continues to make a low sound.

>push the lump
Looking closer at the lump, you realize it is your best friend Ralph curled up asleep!  You wake him up and he slowly comes around.
Ralph says, "Thank you, Teacup!  What happened to us?  I don't remember anything."

>pull the filthy rug
Your snouts wrinkling in disgust, you and Ralph manage to slide the rug off to one side, leaving a trail of dirt and revealing a trap door in the floor!

>open door
You and Ralph put your backs into and apply all of your combined canine power.  There is a loud snapping sound as rusted metal and old wood give way, causing the door to fly open and you and Ralph to tumble over backwards.
The trap door is now open!

>d
Cellar
It is cold and damp here, there is just enough light coming from the room above to see that you are in a stone-walled cellar with exits to the north and south.

>l
Cellar
It is cold and damp here, there is just enough light coming from the room above to see that you are in a stone-walled cellar with exits to the north and south.

>n
You can't go that way.

>s
You can't go that way.

>i
You are carrying nothing.

>l
Cellar
It is cold and damp here, there is just enough light coming from the room above to see that you are in a stone-walled cellar with exits to the north and south.

* * *

>push lump
Looking closer at the lump, you realize it is your best friend Ralph curled up asleep!  You wake him up and he slowly comes around.
"Thank you, Teacup!" Ralph says. "What happened to us?  I don't remember anything."

>l
Small Room
This is a small room with no windows.  It is dimly lit from a grubby ceiling lamp high above your head and shines down on a dirty rug in the middle of the floor.  A doorway to the east is completely filled with a pile of rubble.

Ralph is here beside you, ready to follow your lead.

A dirty rug lies in the center of the room.  It's quite hideous to look at and probably much worse to touch.  It looks quite thick and heavy

A rickety wooden desk with a single drawer sits in the northwest corner of the room.

"Hey, I'm bored," Ralph says. "Let's go for a ramble."

>l
Small Room
This is a small room with no windows.  It is dimly lit from a grubby ceiling lamp high above your head and shines down on a dirty rug in the middle of the floor.  A doorway to the east is completely filled with a pile of rubble.

Ralph is here beside you, ready to follow your lead.

A dirty rug lies in the center of the room.  It's quite hideous to look at and probably much worse to touch.  It looks quite thick and heavy

A rickety wooden desk with a single drawer sits in the northwest corner of the room.

"Hey, I'm bored," Ralph says. "Let's go for a ramble."

I beg your pardon?

>x ralph
Ralph is a young wolf with light gray fur and wearing a blue collar.  He's been your friend and trusty companion with you on more adventures than you can count on with all four paws.

"Hey, I'm bored," Ralph says. "Let's go for a ramble."

>get blue collar
That seems to belong to Ralph.

"Hey, I'm bored," Ralph says. "Let's go for a ramble."

>get collar
That seems to belong to Ralph.

"Hey, I'm bored," Ralph says. "Let's go for a ramble."

>kiss ralph
Keep your mind on the game.

"Hey, I'm bored," Ralph says. "Let's go for a ramble."

>kill ralph
Violence isn't the answer to this one.

"Hey, I'm bored," Ralph says. "Let's go for a ramble."

>take ralph
I don't suppose Ralph would care for that.

"Hey, I'm bored," Ralph says. "Let's go for a ramble."

>whoami
That's not a verb I recognize.

>who am i
That's not a verb I recognize.

>what am i
That's not a verb I recognize.

>x me
You're normally a cute little fox, but right now you look rather stinky.  When this is all over, there will be lots of licking to clean yourself up.

"Hey, I'm bored," Ralph says. "Let's go for a ramble."

>tell ralph to follow me
I didn't understand that sentence.

>ralph, follow me
There is no reply.

"Hey, I'm bored," Ralph says. "Let's go for a ramble."

>d
You can't go that way.

"Hey, I'm bored," Ralph says. "Let's go for a ramble."

>open door
You can't see any such thing.

"Hey, I'm bored," Ralph says. "Let's go for a ramble."

>n
You can't go that way.

"Hey, I'm bored," Ralph says. "Let's go for a ramble."

>push rug
Your snouts wrinkling in disgust, with Ralph's help you manage to slide the rug off to one side, leaving a trail of dirt and revealing a trap door in the floor!

"Hey, I'm bored," Ralph says. "Let's go for a ramble."

>open door
You open the trap door.

"Hey, I'm bored," Ralph says. "Let's go for a ramble."

>d
Cellar
It is cold and damp here, there is just enough light coming from the room above to see that you are in a stone-walled cellar with exits to the north and south.

You must supply a noun.

>l
Cellar
It is cold and damp here, there is just enough light coming from the room above to see that you are in a stone-walled cellar with exits to the north and south.

You must supply a noun.

* * *

>open door
You and Ralph put your backs into and apply all of your combined canine power.  There is a loud snapping sound as rusted metal and old wood give way, causing the door to fly open and you and Ralph to tumble over backwards.
The trap door is now open!

>down
Cellar
It is cold and damp here, there is just enough light coming from the room above to see that you are in a stone-walled cellar with exits to the north and south.

Ralph arrives from above.

>n
Maintenance Room
Maintenance Room description.

Ralph arrives from the south.

>s
Cellar
It is cold and damp here, there is just enough light coming from the room above to see that you are in a stone-walled cellar with exits to the north and south.

Ralph arrives from the north.

>s
Cave-In
Cave-In description.

You can see a peanut here.

Ralph arrives from the north.

>tell ralph to stay here
I didn't understand that sentence.

>ralph, stay here
Ralph ceases to pursue you.

>n
Cellar
It is cold and damp here, there is just enough light coming from the room above to see that you are in a stone-walled cellar with exits to the north and south.

>s
Cave-In
Cave-In description.

Ralph is here beside you, ready to follow your lead.

You can also see a peanut here.

>talk to ralph
"Quite a sticky situation we're in," you say conversationally.

"Yep, but we've been in tougher ones" he replies casually.

>g
"Remember that deal with the hippos and the alligators?" you ask.

"That was a rough one, for sure," Ralph responds, scratching the fur under his collar.

>g
"I've been meaning to ask you about your new collar," you comment. "Where did you get it?"

"My mum gave it to me for Christmas last year," Ralph replies, inspecting his fore paws.

>g
"It looks good with your fur color" you say politely. 

Ralph laughs heartily. "All the cool pups are wearing them you know."

>g
You decide to concentrate on your situation instead of talking further with Ralph right now.

* * *

>open door
You and Ralph put your backs into and apply all of your combined canine power.  There is a loud snapping sound as rusted metal and old wood give way, causing the door to fly open and you and Ralph to tumble over backwards.
The trap door is now open!

>down
Cellar
It is cold and damp here, there is just enough light coming from the room above to see that you are in a stone-walled cellar with exits to the north and south.

You must supply a noun.

* * *

>l
Small Room
This is a small room with no windows.  It is dimly lit from a grubby ceiling lamp high above your head and shines down on a dirty rug in the middle of the floor.  A doorway to the east is completely filled with a pile of rubble.

A dirty rug lies in the center of the room.  It's quite hideous to look at and probably much worse to touch.  It looks quite thick and heavy

A rickety wooden desk with a single drawer sits in the northwest corner of the room.

The lump that you were lying near is here, moving up and down very slightly.  It might be alive!

A low, muffled sound is coming from the lump.

>push lump
Looking closer at the lump, you realize it is your best friend Ralph curled up asleep!  You wake him up and he slowly comes around.
Ralph says, "Thank you, Teacup!  What happened to us?  I don't remember anything."

>l
Small Room
This is a small room with no windows.  It is dimly lit from a grubby ceiling lamp high above your head and shines down on a dirty rug in the middle of the floor.  A doorway to the east is completely filled with a pile of rubble.

Ralph stretches and shakes his fur.

A dirty rug lies in the center of the room.  It's quite hideous to look at and probably much worse to touch.  It looks quite thick and heavy

A rickety wooden desk with a single drawer sits in the northwest corner of the room.

>push rug
Your snouts wrinkling in disgust, with Ralph's help you manage to slide the rug off to one side, leaving a trail of dirt and revealing a trap door in the floor!

>l
Small Room
This is a small room with no windows.  It is dimly lit from a grubby ceiling lamp high above your head and shines down on a trap door in the middle of the floor.  A doorway to the east is completely filled with a pile of rubble.

Ralph stretches and shakes his fur.

The dirty rug has been moved to one side of the room.  You don't want to touch it anymore.

A rickety wooden desk with a single drawer sits in the northwest corner of the room.

>open door
You and Ralph put your backs into and apply all of your combined canine power.  There is a loud snapping sound as rusted metal and old wood give way, causing the door to fly open and you and Ralph to tumble over backwards.
The trap door is now open!

* * *

>d
Cellar
It is cold and damp here, there is just enough light coming from the room above to see that you are in a stone-walled cellar with exits to the north and south.

>n
Maintenance Room
Maintenance Room description.

>s
Cellar
It is cold and damp here, there is just enough light coming from the room above to see that you are in a stone-walled cellar with exits to the north and south.

>s
Cave-In
Cave-In description.

You can see a peanut here.

>l
Cave-In
Cave-In description.

You can see a peanut here.

>get peanut
Taken.

>showme
Cave-In - room
    yourself - person
        peanut

* * *

>wait
Time passes.

The lump looks strangely familiar to you now, and continues to make a low sound.

>push rug
It's no use; the rug is too heavy and grimy to move it by yourself.

The lump is nagging at your brain now, you should really check it out.

>push lump
Looking closer at the lump, you realize it is your best friend Ralph curled up asleep!  You wake him up and he slowly comes around.
Ralph says, "Thank you, Teacup!  What happened to us?  I don't remember anything."

>push rug
Your snouts wrinkling in disgust, with Ralph's help you manage to slide the rug off to one side, leaving a trail of dirt and revealing a trap door in the floor!

* * *

>open door
You and Ralph put your backs into and apply all of your combined canine power.  There is a loud snapping sound as rusted metal and old wood give way, causing the door to fly open and you and Ralph to tumble over backwards.
The trap door is now open!

>d
Cellar
It is cold and damp here, there is just enough light coming from the room above to see that you are in a stone-walled cellar with exits to the north and south.

You must supply a noun.

>s
Cave-In
Cave-In description.

You can see a peanut here.

You must supply a noun.

>l
Cave-In
Cave-In description.

You can see a peanut here.

You must supply a noun.

>look
Cave-In
Cave-In description.

You can see a peanut here.

You must supply a noun.

>wait
Time passes.

You must supply a noun.

* * *

>wait
Time passes.

The lump looks strangely familiar to you now, and continues to make a low sound.

>wait
Time passes.

The lump is nagging at your brain now, you should really check it out.

>wait
Time passes.

The lump is nagging at your brain now, you should really check it out.

* * *

>push rug
It's no use; the rug is too heavy and grimy to move it by yourself.

A low, muffled sound is coming from the lump.

>push lump
Looking closer at the lump, you realize it is your best friend Ralph curled up asleep!  You wake him up and he slowly comes around.
Ralph says, "Thank you, Teacup!  What happened to us?  I don't remember anything."

>push rug
Your snouts wrinkling in disgust, you and Ralph manage to slide the rug off to one side, leaving a trail of dirt and revealing a trap door in the floor!

>push rug
It is fixed in place.

>push rug
It is fixed in place.

* * *

>push rug
Your snouts wrinkling in disgust, you and Ralph manage to slide the rug off to one side, leaving a trail of dirt and revealing a trap door in the floor!

>open door
You and Ralph put your backs into and apply all of your combined canine power.  There is a loud snapping sound as rusted metal and old wood give way, causing the door to fly open and you and Ralph to tumble over backwards.
The trap door is now open!

>push rug
It's too gross.  Stop touching it!

>push rug
It's too gross.  Stop touching it!

>l
Small Room
This is a small room with no windows.  It is dimly lit from a grubby ceiling lamp high above your head and shines down on a trap door in the middle of the floor.

A rickety wooden desk with a single drawer sits in the northwest corner of the room.

You can also see Ralph here.