You are Teacup, an unusually bright and clever fox from Foxtown.  Get ready for your next adventure!

The Adventures of Teacup,
Story time for Teira by Robert Haddon
Release 0 / Serial number 140108 / Inform 7 build 6G60 (I6/v6.32 lib 6/12N) SD

You groan and rub open your eyes with both paws.   You discover that you are lying near a warm and furry lump in the corner of a strange room.  You have no idea how you got here or even where "here" is.

Your last memory is of  Ralph and you starting an investigation at an old building at the edge of Foxtown.  Speaking of Ralph, where is he?

You stand up and brush yourself off.  Satisfied that you have no broken bones or open wounds, it's time to find Ralph and figure out what's happening!

>actions
Actions listing on.

>push lump
[pushing the lump]
Looking closer at the lump, you realize it is your best friend Ralph curled up asleep!  You wake him up and he slowly comes around.
"Thank you, Teacup!" Ralph says. "What happened to us?  I don't remember anything."
[pushing the lump - succeeded]

>pull rug
[pulling the dirty rug]
Your snouts wrinkling in disgust, with Ralph's help you manage to slide the rug off to one side, leaving a trail of dirt and revealing a trap door in the floor!
[pulling the dirty rug - succeeded]

>open door
[opening the trap door]
You and Ralph put your backs into and apply all of your combined canine power.  There is a loud snapping sound as rusted metal and old wood give way, causing the door to fly open and you and Ralph to tumble over backwards.
The trap door is now open!
[opening the trap door - succeeded]

* * *

>test giving
(Testing.)

>[1] push lump
Looking closer at the lump, you realize it is your best friend Ralph curled up asleep!  You wake him up and he slowly comes around.
"Thank you, Teacup!" Ralph says. "What happened to us?  I don't remember anything."

>[2] open drawer
You open the drawer, revealing a leather bound book.

>[3] ralph, get book
Ralph picks up the leather bound book.

>[4] ralph, give book to me
Ralph says, "Good.  I was tired of carrying the leather bound book."

>[5] ralph, give collar to me
"My mum gave me that for Christmas!" Ralph exclaims.  "No way."

Ralph is unable to do that.

>[6] give book to ralph
You hand over the leather bound book to Ralph.

>i
You are carrying nothing.

Ralph is carrying the leather bound book and the blue collar.

I beg your pardon?

>pull rug
Your snouts wrinkling in disgust, with Ralph's help you manage to slide the rug off to one side, leaving a trail of dirt and revealing a trap door in the floor!

>open door
You and Ralph put your backs into and apply all of your combined canine power.  There is a loud snapping sound as rusted metal and old wood give way, causing the door to fly open and you and Ralph to tumble over backwards.
The trap door is now open!

>down
Cellar
It is cold and damp here, there is just enough light coming from the room above to see that you are in a stone-walled cellar with exits to the north and south.  An odd fungus is growing all around.  This place looks ancient, possibly unused for centuries.

Ralph arrives from above.

>ralph, get the fungus
Ralph is unable to do that.

>actions
Actions listing on.

>ralph, get the fungus
[asking Ralph to try taking the odd fungus]
[(1) Ralph taking the odd fungus]
[(1) Ralph taking the odd fungus - failed the can't take scenery rule]

Ralph is unable to do that.
[asking Ralph to try taking the odd fungus - succeeded]

>ralph, get the green
[answering Ralph that "get the green"]
There is no reply.
[answering Ralph that "get the green" - succeeded]

>ralph, get the green fungus
[answering Ralph that "get the green fungus"]
There is no reply.
[answering Ralph that "get the green fungus" - succeeded]

>l
[looking]
Cellar
It is cold and damp here, there is just enough light coming from the room above to see that you are in a stone-walled cellar with exits to the north and south.  An odd fungus is growing all around.  This place looks ancient, possibly unused for centuries.

Ralph is here beside you, ready to follow your lead.

[looking - succeeded]

>get fungus
[taking the odd fungus]
You scrape some of the stuff from between various cracks on the walls until you have enough to hold onto.  It looks greenish and unhealthy.
[taking the odd fungus - succeeded]

>drop fungus
(the green fungus)
[dropping the green fungus]
Dropped.
[dropping the green fungus - succeeded]

>i
[taking inventory]
You are carrying nothing.

Ralph is carrying the leather bound book and the blue collar.
[taking inventory - succeeded]

>l
[looking]
Cellar
It is cold and damp here, there is just enough light coming from the room above to see that you are in a stone-walled cellar with exits to the north and south.  An odd fungus is growing all around.  This place looks ancient, possibly unused for centuries.

Ralph is here beside you, ready to follow your lead.

You can also see a green fungus here.

[looking - succeeded]

>ralph, pick up green fungus
[asking Ralph to try taking the green fungus]
[(1) Ralph taking the green fungus]
Ralph picks up the green fungus.
[(1) Ralph taking the green fungus - succeeded]

[asking Ralph to try taking the green fungus - succeeded]

>i
[taking inventory]
You are carrying nothing.

Ralph is carrying the green fungus, the leather bound book, and the blue collar.
[taking inventory - succeeded]

>ralph, eat green fungus
[asking Ralph to try eating the green fungus]
[(1) Ralph eating the green fungus]
[(1) Ralph eating the green fungus - failed]

[asking Ralph to try eating the green fungus - succeeded]

    *** Against his better judgement, Ralph does as you ask and eats the green fungus.  You watch as his head melts into a puddle of fur and teeth.  Maybe you were smart enough to not eat the green fungus, but now without Ralph you have no hope of getting out of this place alive.

Game over, Teacup! ***

Would you like to RESTART, RESTORE a saved game, QUIT, or UNDO the last command?

* * *

>test giving
(Testing.)

>[1] push lump
You can't see any such thing.

>[2] open drawer
That's already open.

>[3] ralph, get book
Ralph is unable to do that.

>[4] ralph, give book to me
Ralph says, "Good.  I was tired of carrying the leather bound book."

>[5] ralph, give collar to me
"My mum gave me that for Christmas!" Ralph exclaims.  "No way."

Ralph is unable to do that.

>[6] give book to ralph
You hand over the leather bound book to Ralph.

* * *

>test earthquake
(Testing.)

>[1] push lump
Looking closer at the lump, you realize it is your best friend Ralph curled up asleep!  You wake him up and he slowly comes around.
"Thank you, Teacup!" Ralph says. "What happened to us?  I don't remember anything."

>[2] push rug
Your snouts wrinkling in disgust, with Ralph's help you manage to slide the rug off to one side, leaving a trail of dirt and revealing a trap door in the floor!

>[3] open door
You and Ralph put your backs into and apply all of your combined canine power.  There is a loud snapping sound as rusted metal and old wood give way, causing the door to fly open and you and Ralph to tumble over backwards.
The trap door is now open!

>[4] go down

Cellar
It is cold and damp here, there is just enough light coming from the room above to see that you are in a stone-walled cellar with exits to the north and south.  An odd fungus is growing all around.  This place looks ancient, possibly unused for centuries.

Ralph arrives from above.

>[5] go north

Old Storage Area
The stone-walled tunnel ends here, in what looks like an old storage area, based on the rotting crates lying about.

There are some ancient storage crates here.

You can also see a glowing fungus (providing light) here.

Ralph arrives from the south.

>[6] get fungus
Taken.

>[7] go south

Cellar
It is cold and damp here, there is just enough light coming from the room above to see that you are in a stone-walled cellar with exits to the north and south.  An odd fungus is growing all around.  This place looks ancient, possibly unused for centuries.

Ralph arrives from the north.

>[8] go south

Before you can leave, Ralph grabs your shoulder. "Teacup, listen!  Can you hear that?  Let's get out of here, now!"
You shrug your haunches and continue anyway. "What choice do we have?" You ask.

Cave-In
It is hard to say how far south the old stone-walled tunnel once led, because at the south end of the room the roof has collapsed, making the way now impassible.  

The ground is shifting under your paws and your hackles are rising:  you sense danger here!

You can see a peanut here.

Ralph arrives from the north.

>[9] get peanut
Taken.

Boooooom!!!
The whole room begins to shake violently!  You can't tell if it is an earthquake or if a bomb has gone off somewhere near by, but you have no time to think about it as the floor on which you and Ralph are standing suddenly collapses!  You slip off your feet and tumble into a huge crack that has opened underneath you.

During your tumble, you dropped everything you were carrying!

Your ears are ringing and thick falling dust prevents you from seeing anything.

Darkness
It is pitch dark, and you can't see a thing.

I beg your pardon?

>wait
Time passes.

The dust finally settles enough for you to see where you are.

Dining Hall
This is an elloborately decorated room with rich wood paneling on the walls and a large wooden table in the middle surrounded by fancy chairs.  The west end of the room is a mess of debris from the recent disaster, covering half the table and some of the chairs.  Hanging from the ceiling is an iron chandalier, providing light. There are doorways leading north and east.  On the west wall hangs a large tapestry.

Ralph is here beside you, ready to follow your lead.

You can also see a glowing fungus (providing light) and a peanut here.

>i
You are carrying nothing.

Ralph is carrying the blue collar.

>ralph, give me the collar
Ralph is unable to do that.

>ask ralph to get the peanut
I didn't understand that sentence.

>tell ralph to get the peanut
I didn't understand that sentence.

>give the peanut to ralph
(first taking the peanut)
Ralph sniffs the peanut carefully.  "Mmm...smells good!"

>i
You are carrying nothing.

Ralph is carrying the peanut and the blue collar.

>take peanut
That seems to belong to Ralph.

>ask ralph to give the peanut
I didn't understand that sentence.

>ralph, give peanut
(to Ralph)
Ralph is unable to do that.

>ralph, drop peanut
Ralph puts down the peanut.

>i
You are carrying nothing.

Ralph is carrying the blue collar.

>l
Dining Hall
This is an elloborately decorated room with rich wood paneling on the walls and a large wooden table in the middle surrounded by fancy chairs.  The west end of the room is a mess of debris from the recent disaster, covering half the table and some of the chairs.  Hanging from the ceiling is an iron chandalier, providing light. There are doorways leading north and east.  On the west wall hangs a large tapestry.

Ralph is here beside you, ready to follow your lead.

You can also see a peanut and a glowing fungus (providing light) here.

>ralph, eat peanut
(Ralph first taking the peanut)
Ralph eats the peanut.

>i
You are carrying nothing.

Ralph is carrying the blue collar.

>ralph, stay here
Ralph ceases to pursue you.

>w
You can't go that way.

>e
Darkness
It is pitch dark, and you can't see a thing.

"Woah!" you exclaim.  "I feel grass under my paws!"
 You wonder how a dark room underground can grow grass.

>w
Dining Hall
This is an elloborately decorated room with rich wood paneling on the walls and a large wooden table in the middle surrounded by fancy chairs.  The west end of the room is a mess of debris from the recent disaster, covering half the table and some of the chairs.  Hanging from the ceiling is an iron chandalier, providing light. There are doorways leading north and east.  On the west wall hangs a large tapestry.

Ralph is here beside you, ready to follow your lead.

You can also see a glowing fungus (providing light) here.

>ralph, follow me
Ralph begins to follow you.

I beg your pardon?

>i
You are carrying nothing.

Ralph is carrying the blue collar.

>l
Dining Hall
This is an elloborately decorated room with rich wood paneling on the walls and a large wooden table in the middle surrounded by fancy chairs.  The west end of the room is a mess of debris from the recent disaster, covering half the table and some of the chairs.  Hanging from the ceiling is an iron chandalier, providing light. There are doorways leading north and east.  On the west wall hangs a large tapestry.

Ralph is here beside you, ready to follow your lead.

You can also see a glowing fungus (providing light) here.

>ralph, take fungus
Ralph picks up the glowing fungus.

>i
You are carrying nothing.

Ralph is carrying the glowing fungus and the blue collar.

>l
Dining Hall
This is an elloborately decorated room with rich wood paneling on the walls and a large wooden table in the middle surrounded by fancy chairs.  The west end of the room is a mess of debris from the recent disaster, covering half the table and some of the chairs.  Hanging from the ceiling is an iron chandalier, providing light. There are doorways leading north and east.  On the west wall hangs a large tapestry.

Ralph is here beside you, ready to follow your lead.

>ralph, drop collar
Ralph puts down the blue collar.

>take collar
Taken.

>ralph, take collar
Ralph is unable to do that.

>drop collar
Dropped.

>ralph, take collar
Ralph picks up the blue collar.

>i
You are carrying nothing.

Ralph is carrying the blue collar and the glowing fungus.

>i
You are carrying nothing.

Ralph is carrying the blue collar and the glowing fungus.

>ralph, drop collar
Ralph puts down the blue collar.

>get collar
Taken.

>give collar to ralph
You hand over the blue collar to Ralph.

>ralph, take collar
Ralph is unable to do that.

>i
You are carrying nothing.

Ralph is carrying the blue collar and the glowing fungus.

>ralph, get collar
Ralph is unable to do that.

>give collar to ralph
(first taking the blue collar)
That seems to belong to Ralph.

>i
You are carrying nothing.

Ralph is carrying the blue collar and the glowing fungus.

>actions
Actions listing on.

>give collar to ralph
[giving the blue collar to Ralph]
(first taking the blue collar)
[(1) taking the blue collar - silently]
That seems to belong to Ralph.
[(1) taking the blue collar - silently - failed the can't take people's possessions rule]
[giving the blue collar to Ralph - failed the carrying requirements rule]

>restart
[restarting the game]
Are you sure you want to restart?

* * *

>push lump
Looking closer at the lump, you realize it is your best friend Ralph curled up asleep!  You wake him up and he slowly comes around.
"Thank you, Teacup!" Ralph says. "What happened to us?  I don't remember anything."

>open drawer
You open the drawer, revealing a leather bound book.

* * *

>get book
Taken.

>give book to ralph
You hand over the leather bound book to Ralph.

>i
You are carrying nothing.

Ralph is carrying the leather bound book and the blue collar.

>pull rug
Your snouts wrinkling in disgust, with Ralph's help you manage to slide the rug off to one side, leaving a trail of dirt and revealing a trap door in the floor!

* * *

>down
Cellar
It is cold and damp here, there is just enough light coming from the room above to see that you are in a stone-walled cellar with exits to the north and south.  An odd fungus is growing all around.  This place looks ancient, possibly unused for centuries.

Ralph arrives from above.

>get fungus
You scrape some of the stuff from between various cracks on the walls until you have enough to hold onto.  It looks greenish and unhealthy.

>give fungus to ralph
(the green fungus to Ralph)
Ralph politely declines your offer to poison him.

>n
Old Storage Area
The stone-walled tunnel ends here, in what looks like an old storage area, based on the rotting crates lying about.

There are some ancient storage crates here.

You can also see a glowing fungus (providing light) here.

Ralph arrives from the south.

>get fungus
(the glowing fungus)
Taken.

>actions
Actions listing on.

>give fungus to ralph
Which do you mean, the glowing fungus or the green fungus?

>give glowing to ralph
[giving the glowing fungus to Ralph]
Ralph sniffs the glowing fungus carefully.  "Mmm...smells good!"
[giving the glowing fungus to Ralph - succeeded]

>i
[taking inventory]
You are carrying:
  a green fungus

Ralph is carrying the glowing fungus, the leather bound book, and the blue collar.
[taking inventory - succeeded]

>actions off
Actions listing off.

>ralph, drop all
glowing fungus: Ralph puts down the glowing fungus.
leather bound book: Ralph puts down the leather bound book.

>i
You are carrying:
  a green fungus

Ralph is carrying the blue collar.

>ralph, drop the collar
Ralph puts down the blue collar.

>i
You are carrying:
  a green fungus

Ralph is carrying nothing.

I beg your pardon?

>give collar to ralph
(first taking the blue collar)
You hand over the blue collar to Ralph.

>ralph, give
(Ralph the blue collar)
Ralph is unable to do that.

>actions
Actions listing on.

>ralph, give
(Ralph the blue collar)
[asking Ralph to try giving the blue collar to Ralph]
[(1) Ralph giving the blue collar to Ralph]
[(1) Ralph giving the blue collar to Ralph - failed the can't give to yourself rule]

Ralph is unable to do that.
[asking Ralph to try giving the blue collar to Ralph - succeeded]

>ralph, give collar to me
[asking Ralph to try giving the blue collar to yourself]
[(1) Ralph giving the blue collar to yourself]
"My mum gave me that for Christmas!", Ralph exclaims.  "No way."
[(1) Ralph giving the blue collar to yourself - failed]

Ralph is unable to do that.
[asking Ralph to try giving the blue collar to yourself - succeeded]

* * *

>open drawer
You open the drawer, revealing a leather bound book.

>ralph, get the book
Ralph picks up the leather bound book.

>i
You are carrying nothing.

Ralph is carrying the leather bound book and the blue collar.

>ask ralph for the book
Ralph is unable to do that.

>ralph, give the book
(to Ralph)
Ralph is unable to do that.

>ask ralph for the book
Ralph is unable to do that.

>ask ralph to give me the book
I didn't understand that sentence.

>ask ralph, give me the book
You can't use multiple objects with that verb.

>tell ralph to give me the book
I didn't understand that sentence.

>get book from ralph
That seems to belong to Ralph.

>restart
Are you sure you want to restart?

* * *

>push lump
Looking closer at the lump, you realize it is your best friend Ralph curled up asleep!  You wake him up and he slowly comes around.
"Thank you, Teacup!" Ralph says. "What happened to us?  I don't remember anything."

>ralph, get snarf
Ralph picks up the snarf.

>ralph, eat snarf
    *** Against his better judgement, Ralph does as you ask and eats the snarf.  

 He whimpers a bit from the pain in his stomach, then he falls over dead.  Maybe you were smart enough to not eat the snarf, but now without Ralph you have no hope of getting out of this place alive.

Game over, Teacup! ***

Would you like to RESTART, RESTORE a saved game, QUIT, or UNDO the last command?

* * *

>pull rug
Your snouts wrinkling in disgust, with Ralph's help you manage to slide the rug off to one side, leaving a trail of dirt and revealing a trap door in the floor!

>restart
Are you sure you want to restart?

* * *

>get fungus
You scrape some of the stuff from between various cracks on the walls until you have enough to hold onto.  It looks greenish and unhealthy.

>eat fungus
(the green fungus)

    *** Didn't your parents ever warn you about eating unknown fungi?  You should have listened to them more carefully, because your experience with eating the green fungus does not go well.

The horrible taste of the stuff was not the worst part.  The hours of painful stomach cramps and hallucinations also were not the worst part.  The worst part was definitely when your head melted and you died.

Ralph was smart enough not to eat the green fungus, but not smart enough to escape this place without your help.  So he died a few days after you did, lonely and miserable.

Game over, Teacup! ***

Would you like to RESTART, RESTORE a saved game, QUIT, or UNDO the last command?

* * *

>push rug
Your snouts wrinkling in disgust, with Ralph's help you manage to slide the rug off to one side, leaving a trail of dirt and revealing a trap door in the floor!

>open door
You and Ralph put your backs into and apply all of your combined canine power.  There is a loud snapping sound as rusted metal and old wood give way, causing the door to fly open and you and Ralph to tumble over backwards.
The trap door is now open!

* * *

>get fungus
You scrape some of the stuff from between various cracks on the walls until you have enough to hold onto.  It looks greenish and unhealthy.

>north
Old Storage Area
The stone-walled tunnel ends here, in what looks like an old storage area, based on the rotting crates lying about.

There are some ancient storage crates here.

You can also see a glowing fungus (providing light) here.

Ralph arrives from the south.

>get glowing fungus
Taken.

>south
Cellar
It is cold and damp here, there is just enough light coming from the room above to see that you are in a stone-walled cellar with exits to the north and south.  An odd fungus is growing all around.  This place looks ancient, possibly unused for centuries.

Ralph arrives from the north.

>south
Before you can leave, Ralph grabs your shoulder. "Teacup, listen!  Can you hear that?  Let's get out of here, now!"
You shrug your haunches and continue anyway. "What choice do we have?" You ask.

Cave-In
It is hard to say how far south the old stone-walled tunnel once led, because at the south end of the room the roof has collapsed, making the way now impassible.  

The ground is shifting under your paws and your hackles are rising:  you sense danger here!

You can see a peanut here.

Ralph arrives from the north.

>get peanut
Taken.

Boooooom!!!
The whole room begins to shake violently!  You can't tell if it is an earthquake or if a bomb has gone off somewhere near by, but you have no time to think about it as the floor on which you and Ralph are standing suddenly collapses!  You slip off your feet and tumble into a huge crack that has opened underneath you.

During your tumble, you dropped everything you were carrying!

Your ears are ringing and thick falling dust prevents you from seeing anything.

Darkness
It is pitch dark, and you can't see a thing.

* * *

>down
Cellar
It is cold and damp here, there is just enough light coming from the room above to see that you are in a stone-walled cellar with exits to the north and south.  An odd fungus is growing all around.  This place looks ancient, possibly unused for centuries.

Ralph arrives from above.

>eat fungus
(first taking the odd fungus)
You scrape some of the stuff from between various cracks on the walls until you have enough to hold onto.  It looks greenish and unhealthy.

I beg your pardon?

>i
You are carrying:
  a green fungus

Ralph is carrying the blue collar.

>eat fungus
(the green fungus)

    *** Didn't your parents ever warn you about eating unknown fungi?  You should have listened to them more carefully, because your experience with eating the green fungus does not go well.

The horrible taste of the stuff was not the worst part.  The hours of painful stomach cramps and hallucinations also were not the worst part.  The worst part was definitely when your head melted and you died.

Ralph was smart enough not to eat the green fungus, but not smart enough to escape this place without your help.  So he died a few days after you did, lonely and miserable.

Game over, Teacup! ***

Would you like to RESTART, RESTORE a saved game, QUIT, or UNDO the last command?

* * *

>push lump
Looking closer at the lump, you realize it is your best friend Ralph curled up asleep!  You wake him up and he slowly comes around.
"Thank you, Teacup!" Ralph says. "What happened to us?  I don't remember anything."

>ralph, give me the collar
"My mum gave me that for Christmas!" Ralph exclaims.  "No way."

Ralph is unable to do that.

>test
>--> The following tests are available:
'test Earthquake'
'test giving'

* * *

>l
Small Room
This is a small room with no windows.  It is dimly lit from a grubby ceiling lamp high above your head and shines down on a dirty rug in the middle of the floor.  A doorway to the east is completely filled with a pile of rubble.

A dirty rug lies in the center of the room.  It's horrible looking and probably much worse to touch.  It looks quite thick and heavy, though with some help you could probably move it.

A rickety wooden desk with a single drawer sits in the northwest corner of the room.

The lump that you were lying near is here, moving up and down very slightly.  It might be alive!

Yucky snarf.

A low, muffled sound is coming from the lump.

>get snarf
Taken.

The lump looks strangely familiar to you now, and continues to make a low sound.

>eat snarf
    *** You whimper in pain, then make a horrible mess on the floor as you die.

Ralph was smart enough not to eat the snarf, but not smart enough to escape this place without your help.  So he died a few days after you did, lonely and miserable.

Game over, Teacup! ***

Would you like to RESTART, RESTORE a saved game, QUIT, or UNDO the last command?

* * *

>test
>--> The following tests are available:
'test ralph-poison'
'test giving'
'test Earthquake'

>test ralph-poision
(Testing.)

>[1] push lump
Looking closer at the lump, you realize it is your best friend Ralph curled up asleep!  You wake him up and he slowly comes around.
"Thank you, Teacup!" Ralph says. "What happened to us?  I don't remember anything."

>[2] pull rug
Your snouts wrinkling in disgust, with Ralph's help you manage to slide the rug off to one side, leaving a trail of dirt and revealing a trap door in the floor!

>[3] open door
You and Ralph put your backs into and apply all of your combined canine power.  There is a loud snapping sound as rusted metal and old wood give way, causing the door to fly open and you and Ralph to tumble over backwards.
The trap door is now open!

>[4] d

Cellar
It is cold and damp here, there is just enough light coming from the room above to see that you are in a stone-walled cellar with exits to the north and south.  An odd fungus is growing all around.  This place looks ancient, possibly unused for centuries.

Ralph arrives from above.

>[5] get fungus
You scrape some of the stuff from between various cracks on the walls until you have enough to hold onto.  It looks greenish and unhealthy.

>[6] drop fungus
(the green fungus)
Dropped.

>[7] ralph, get green fungus
Ralph picks up the green fungus.

>[8] ralph, eat green fungus

    *** Against his better judgement, Ralph does as you ask and eats the green fungus.  

You watch as his head melts into a puddle of fur and teeth, then he falls over dead.  Maybe you were smart enough to not eat the green fungus, but now without Ralph you have no hope of getting out of this place alive.

Game over, Teacup! ***

Would you like to RESTART, RESTORE a saved game, QUIT, or UNDO the last command?

Please give one of the answers above.

Would you like to RESTART, RESTORE a saved game, QUIT, or UNDO the last command?

>undo
Cellar
[Previous turn undone.]

>get green
That seems to belong to Ralph.

>ralph, give green fungus to me
Ralph says, "Good.  I was tired of carrying the green fungus."

>eat it
    *** Didn't your parents ever warn you about eating unknown fungi?  You should have listened to them more carefully, because your experience with eating the green fungus does not go well.

The horrible taste of the stuff was not the worst part.  The hours of painful stomach cramps and hallucinations also were not the worst part.  The worst part was definitely when your head melted and you died.

Ralph was smart enough not to eat the green fungus, but not smart enough to escape this place without your help.  So he died a few days after you did, lonely and miserable.

Game over, Teacup! ***

Would you like to RESTART, RESTORE a saved game, QUIT, or UNDO the last command?

* * *

>test
>--> The following tests are available:
'test ralph-poison'
'test giving'
'test Earthquake'

>test giving
(Testing.)

>[1] restart
Are you sure you want to restart?

>drop the book
Dropped.

>ralph, get book
Ralph picks up the leather bound book.

* * *

>test
>--> The following tests are available:
'test ralph-poison'
'test giving'
'test Earthquake'

>test ralph-poison
(Testing.)

>[1] push lump
Looking closer at the lump, you realize it is your best friend Ralph curled up asleep!  You wake him up and he slowly comes around.
"Thank you, Teacup!" Ralph says. "What happened to us?  I don't remember anything."

>[2] pull rug
Your snouts wrinkling in disgust, with Ralph's help you manage to slide the rug off to one side, leaving a trail of dirt and revealing a trap door in the floor!

>[3] open door
You and Ralph put your backs into and apply all of your combined canine power.  There is a loud snapping sound as rusted metal and old wood give way, causing the door to fly open and you and Ralph to tumble over backwards.
The trap door is now open!

You open the trap door.

>[4] d

Cellar
It is cold and damp here, there is just enough light coming from the room above to see that you are in a stone-walled cellar with exits to the north and south.  An odd fungus is growing all around.  This place looks ancient, possibly unused for centuries.

Ralph arrives from above.

>[5] get fungus
You scrape some of the stuff from between various cracks on the walls until you have enough to hold onto.  It looks greenish and unhealthy.

>[6] drop fungus
(the green fungus)
Dropped.

>[7] ralph, get green fungus
Ralph picks up the green fungus.

>[8] ralph, eat green fungus
Against his better judgement, Ralph does as you ask and eats the green fungus.  

You watch as his head melts into a puddle of fur and teeth, then he falls over dead.  Maybe you were smart enough to not eat the green fungus, but now without Ralph you have no hope of getting out of this place alive.

Game over, Teacup!

    *** You have died. ***

Would you like to RESTART, RESTORE a saved game, QUIT, or UNDO the last command?

>undo
Cellar
[Previous turn undone.]

>i
You are carrying nothing.

Ralph is carrying the green fungus and the blue collar.

>ralph, give green to me
Ralph says, "Good.  I was tired of carrying the green fungus."

>eat green
Didn't your parents ever warn you about eating unknown fungi?  You should have listened to them more carefully, because your experience with eating the green fungus does not go well.

The horrible taste of the stuff was not the worst part.  The hours of painful stomach cramps and hallucinations also were not the worst part.  The worst part was definitely when your head melted and you died.

Ralph was smart enough not to eat the green fungus, but not smart enough to escape this place without your help.  So he died a few days after you did, lonely and miserable.

Game over, Teacup!

    *** You have died. ***

Would you like to RESTART, RESTORE a saved game, QUIT, or UNDO the last command?