You are Teacup, an unusually bright and clever fox from Foxtown.

You groan and rub open your eyes with both paws.   You discover that you are lying near a warm and furry lump in the corner of a strange room.  You have no idea how you got here or even where "here" is.  It's time to find some answers, Teacup!

The Adventures of Teacup, Episode 1
Story time for Teira by Robert Haddon
Release 0 / Serial number 140106 / Inform 7 build 6G60 (I6/v6.32 lib 6/12N) SD

Small Room
This is a small room with no windows.  It is dimly lit from a grubby ceiling lamp high above your head and shines down on a dirty rug in the middle of the floor.  A doorway to the east is completely filled with a pile of rubble.

A dirty rug lies in the center of the room.  It's horrible looking and probably much worse to touch.  It looks quite thick and heavy, though with some help you could probably move it.

A rickety wooden desk with a single drawer sits in the northwest corner of the room.

The lump that you were lying near is here, moving up and down very slightly.  It might be alive!

* * *

That's not a verb I recognize.

* * *

>push lump. push rug. open trap door. down.
Looking closer at the lump, you realize it is your best friend Ralph curled up asleep!  You wake him up and he slowly comes around.
"Thank you, Teacup!" Ralph says. "What happened to us?  I don't remember anything."

Your snouts wrinkling in disgust, with Ralph's help you manage to slide the rug off to one side, leaving a trail of dirt and revealing a trap door in the floor!

You and Ralph put your backs into and apply all of your combined canine power.  There is a loud snapping sound as rusted metal and old wood give way, causing the door to fly open and you and Ralph to tumble over backwards.
The trap door is now open!

Cellar
It is cold and damp here, there is just enough light coming from the room above to see that you are in a stone-walled cellar with exits to the north and south.  An odd fungus is growing all around.  There's something about this place that tells you it is old...very old.

Ralph arrives from above.

>get fungus
You scrap some of the stuff from a crack between two stones on a wall.  It looks greenish and unhealthy.

>g
(the green fungus)
You already have that.

>eat fungus
(the green fungus)
You eat the green fungus. Not bad.

>get fungus
There's no more left!

* * *

>get fungus
You scrap some of the stuff from a crack between two stones on a wall.  It looks greenish and unhealthy.

>eat fungus
(the green fungus)

    *** Your head explodes (which means you are dead). ***

Would you like to RESTART, RESTORE a saved game, QUIT, or UNDO the last command?

* * *

>get fungus
You scrap some of the stuff from a crack between two stones on a wall.  It looks greenish and unhealthy.

>throw fungus at ralph
(the green fungus at Ralph)
 Ralph says "Is that really the best way for us to get out of this trap?"

>get green fungus.  throw green fungus at ralph.
Taken.

 Like a furball ninja, Ralph easily dodges the green fungus, where it falls harmlessly to the ground.

>g
(first taking the green fungus)
 Ralph says "Is that really the best way for us to get out of this trap?"

>g
(first taking the green fungus)
 Like a furball ninja, Ralph easily dodges the green fungus, where it falls harmlessly to the ground.

>g
(first taking the green fungus)
 Ralph says "Is that really the best way for us to get out of this trap?"

>g
(first taking the green fungus)
 Quick as a fox, or a wolf, rather, Ralph bats the green fungus back in your direction and it hits you in the face!

>g
(first taking the green fungus)
 The green fungus completely misses.  Ralph looks at you with a raised eyebrow.

>g
(first taking the green fungus)
 Quick as a fox, or a wolf, rather, Ralph bats the green fungus back in your direction and it hits you in the face!

* * *

>g
(first taking the green fungus)
 The green fungus completely misses.  Ralph looks at you with a raised eyebrow.

>n
Old Storage Area
Old Storage Area description.

You can see a glowing fungus (providing light) here.

Ralph arrives from the south.

>get fungus
Taken.

>s
Cellar
It is cold and damp here, there is just enough light coming from the room above to see that you are in a stone-walled cellar with exits to the north and south.  An odd fungus is growing all around.  There's something about this place that tells you it is old...very old.

You can see a green fungus here.

Ralph arrives from the north.

>s
Cave-In
Cave-In description.

You can see a peanut here.

Ralph arrives from the north.

>get peanut
Taken.

>throw peanut at ralph
 Quick as a fox, or a wolf, rather, Ralph bats the peanut back in your direction and it hits you in the face!

>i
You are carrying:
  a glowing fungus (providing light)

>eat fungus
You eat the glowing fungus. Not bad.

It is now pitch dark in here!

>n
Cellar
It is cold and damp here, there is just enough light coming from the room above to see that you are in a stone-walled cellar with exits to the north and south.  An odd fungus is growing all around.  There's something about this place that tells you it is old...very old.

You can see a green fungus here.

Ralph arrives from the south.

>n
Darkness
It is pitch dark, and you can't see a thing.

>s
Cellar
It is cold and damp here, there is just enough light coming from the room above to see that you are in a stone-walled cellar with exits to the north and south.  An odd fungus is growing all around.  There's something about this place that tells you it is old...very old.

You can see a green fungus here.

Ralph arrives from the north.

>vomit
That's not a verb I recognize.

>barf
That's not a verb I recognize.

* * *

>x fungus
Slimey stuff, for sure.  It looks like you could scrap some off.

>get fungus
You scrap some of the stuff from a crack between two stones on a wall.  It looks greenish and unhealthy.

>i
You are carrying:
  a green fungus

>get fungus
(the green fungus)
You already have that.

>s
Darkness
It is pitch dark, and you can't see a thing.

>drop fungus
Dropped.

>n
Cellar
It is cold and damp here, there is just enough light coming from the room above to see that you are in a stone-walled cellar with exits to the north and south.  An odd fungus is growing all around.  There's something about this place that tells you it is old...very old.

Ralph arrives from the south.

>get fungus
There's no more left!

>eat fungus
(first taking the odd fungus)
There's no more left!

>s
Darkness
It is pitch dark, and you can't see a thing.

* * *

>x fungus
Slimey stuff, for sure.  It looks like you could scrap some off.

>showme
Cellar - room
    Ralph - wolf
        blue collar (worn)
    trap door - secret door
    yourself - person
    odd fungus

>x green
You can't see any such thing.

>x green fungus
You can't see any such thing.

>x odd
Slimey stuff, for sure.  It looks like you could scrap some off.

>get odd
You scrap some of the stuff from a crack between two stones on a wall.  It looks greenish and unhealthy.

>n
Old Storage Area
Old Storage Area description.

Ralph arrives from the south.

>drop fungus
Dropped.

>s
Cellar
It is cold and damp here, there is just enough light coming from the room above to see that you are in a stone-walled cellar with exits to the north and south.  An odd fungus is growing all around.  There's something about this place that tells you it is old...very old.

Ralph arrives from the north.

>get odd
You spend some time scraping your claws in the cracks between the stones but you fail to get enough to hold on to.

>n
Old Storage Area
Old Storage Area description.

You can see a green fungus here.

Ralph arrives from the south.

>get fungus
Taken.

>feed fungus to ralph
Ralph politely declines your offer to poison him.

>eat fungus
    *** Didn't your parents ever warn you about eating unknown fungi?  You should have listened to them more carefully, because your experience with eating the green fungus does not go well.

The horrible taste of the stuff was not the worst part.  The hours of painful stomach cramps and hallucinations also were not the worst part.  The worst part was definitely when your head melted and you died.

Ralph was smart enough not to eat the green fungus, but not smart enough to escape this place without your help.  So he died a few days after you did, lonely and miserable. ***

Would you like to RESTART, RESTORE a saved game, QUIT, or UNDO the last command?

* * *

>push lump. push rug. open door. down. south. get peanut.
Looking closer at the lump, you realize it is your best friend Ralph curled up asleep!  You wake him up and he slowly comes around.
"Thank you, Teacup!" Ralph says. "What happened to us?  I don't remember anything."

Your snouts wrinkling in disgust, with Ralph's help you manage to slide the rug off to one side, leaving a trail of dirt and revealing a trap door in the floor!

You and Ralph put your backs into and apply all of your combined canine power.  There is a loud snapping sound as rusted metal and old wood give way, causing the door to fly open and you and Ralph to tumble over backwards.
The trap door is now open!

Cellar
It is cold and damp here, there is just enough light coming from the room above to see that you are in a stone-walled cellar with exits to the north and south.

Ralph arrives from above.

Cave-In
Cave-In description.

You can see a peanut here.

Ralph arrives from the north.

Taken.

>eat peanut
You eat the peanut, shell and all.  Most folks just eat the inside part.

>poop
That's not a verb I recognize.

>pee
That's not a verb I recognize.

* * *

>crack peanut
You crack open the shell and find a note inside!

>i
You are carrying:
  a secret note

>read note
It reads: THEPOO

* * *

I beg your pardon?

>crack peanut
You crack open the shell and find a note inside!

* * *

>push lump. push rug. open door. down
Looking closer at the lump, you realize it is your best friend Ralph curled up asleep!  You wake him up and he slowly comes around.
"Thank you, Teacup!" Ralph says. "What happened to us?  I don't remember anything."

Your snouts wrinkling in disgust, with Ralph's help you manage to slide the rug off to one side, leaving a trail of dirt and revealing a trap door in the floor!

You and Ralph put your backs into and apply all of your combined canine power.  There is a loud snapping sound as rusted metal and old wood give way, causing the door to fly open and you and Ralph to tumble over backwards.
The trap door is now open!

Cellar
It is cold and damp here, there is just enough light coming from the room above to see that you are in a stone-walled cellar with exits to the north and south.  An odd fungus is growing all around.  This place looks ancient, possibly unused for centuries.

Ralph arrives from above.

* * *

That's not a verb I recognize.

>push lump. push rug. open door. down. get odd fungus.  north.  get glowing fungus. south. south. get peanut.
You can't see any such thing.

* * *

>push lump
Looking closer at the lump, you realize it is your best friend Ralph curled up asleep!  You wake him up and he slowly comes around.
"Thank you, Teacup!" Ralph says. "What happened to us?  I don't remember anything."

* * *

>down
Cellar
It is cold and damp here, there is just enough light coming from the room above to see that you are in a stone-walled cellar with exits to the north and south.  An odd fungus is growing all around.  This place looks ancient, possibly unused for centuries.

Ralph arrives from above.

>get fungus
You scrap some of the stuff from a crack between two stones on a wall.  It looks greenish and unhealthy.

>north
Old Storage Area
The stone-walled tunnel ends here, in what looks like an old storage area, based on the rotting crates lying about.

There are some ancient storage crates here.

You can also see a glowing fungus (providing light) here.

Ralph arrives from the south.

* * *

>south
Cellar
It is cold and damp here, there is just enough light coming from the room above to see that you are in a stone-walled cellar with exits to the north and south.  An odd fungus is growing all around.  This place looks ancient, possibly unused for centuries.

Ralph arrives from the north.

>s
Cave-In
It is hard to say how far south the old stone-walled tunnel once led, because at the south end of the room the roof has collapsed, making the way now impassible.  Your hackles are rising:  you sense danger here!

You can see a peanut here.

"I don't like it here, Teacup," Ralph informs you.

Ralph arrives from the north.

>x peanut
You see nothing special about the peanut.

>crack peanut
You crack open the shell and find a note inside!

Your presence in this area is too much for the fragile

>d
You can't go that way.

Your presence in this area is too much for the fragile

>d
You can't go that way.

Your presence in this area is too much for the fragile

>wait
Time passes.

Your presence in this area is too much for the fragile

>g
Time passes.

Your presence in this area is too much for the fragile

>g
Time passes.

Your presence in this area is too much for the fragile

* * *

>south
Cellar
It is cold and damp here, there is just enough light coming from the room above to see that you are in a stone-walled cellar with exits to the north and south.  An odd fungus is growing all around.  This place looks ancient, possibly unused for centuries.

Ralph arrives from the north.

>south
"I don't like it here, Teacup," Ralph informs you.

Cave-In
It is hard to say how far south the old stone-walled tunnel once led, because at the south end of the room the roof has collapsed, making the way now impassible.  Your hackles are rising:  you sense danger here!

You can see a peanut here.

Ralph arrives from the north.

>s
You can't go that way.

>l
Cave-In
It is hard to say how far south the old stone-walled tunnel once led, because at the south end of the room the roof has collapsed, making the way now impassible.  Your hackles are rising:  you sense danger here!

Ralph is here beside you, ready to follow your lead.

You can also see a peanut here.

* * *

>south
"I don't like it here, Teacup," Ralph informs you.

Cave-In
It is hard to say how far south the old stone-walled tunnel once led, because at the south end of the room the roof has collapsed, making the way now impassible.  Your hackles are rising:  you sense danger here!

You can see a peanut here.

Ralph arrives from the north.

>l
Cave-In
It is hard to say how far south the old stone-walled tunnel once led, because at the south end of the room the roof has collapsed, making the way now impassible.  Your hackles are rising:  you sense danger here!

Ralph is here beside you, ready to follow your lead.

You can also see a peanut here.

>n
Cellar
It is cold and damp here, there is just enough light coming from the room above to see that you are in a stone-walled cellar with exits to the north and south.  An odd fungus is growing all around.  This place looks ancient, possibly unused for centuries.

Ralph arrives from the south.

>s
Cave-In
It is hard to say how far south the old stone-walled tunnel once led, because at the south end of the room the roof has collapsed, making the way now impassible.  Your hackles are rising:  you sense danger here!

You can see a peanut here.

Ralph arrives from the north.

* * *

>push lump. push rug. open door. down. get odd fungus.  north.  get glowing fungus. south. south. get peanut.
Looking closer at the lump, you realize it is your best friend Ralph curled up asleep!  You wake him up and he slowly comes around.
"Thank you, Teacup!" Ralph says. "What happened to us?  I don't remember anything."

Your snouts wrinkling in disgust, with Ralph's help you manage to slide the rug off to one side, leaving a trail of dirt and revealing a trap door in the floor!

You and Ralph put your backs into and apply all of your combined canine power.  There is a loud snapping sound as rusted metal and old wood give way, causing the door to fly open and you and Ralph to tumble over backwards.
The trap door is now open!

Cellar
It is cold and damp here, there is just enough light coming from the room above to see that you are in a stone-walled cellar with exits to the north and south.  An odd fungus is growing all around.  This place looks ancient, possibly unused for centuries.

Ralph arrives from above.

You scrap some of the stuff from a crack between two stones on a wall.  It looks greenish and unhealthy.

Old Storage Area
The stone-walled tunnel ends here, in what looks like an old storage area, based on the rotting crates lying about.

There are some ancient storage crates here.

You can also see a glowing fungus (providing light) here.

Ralph arrives from the south.

Taken.

Cellar
It is cold and damp here, there is just enough light coming from the room above to see that you are in a stone-walled cellar with exits to the north and south.  An odd fungus is growing all around.  This place looks ancient, possibly unused for centuries.

Ralph arrives from the north.

Cave-In
Cave-In description.

You can see a peanut here.

Ralph arrives from the north.

Taken.

>give peanut to ralph
Ralph thanks you and "wolfs" down the peanut.

>i
You are carrying:
  a glowing fungus (providing light)
  a green fungus

>x ralph
Ralph is a young wolf with light gray fur and wearing a blue collar.  He's been your friend and trusty companion with you on more adventures than you can count on with all four paws.

>x blue collar
This is no cheap PetSmart dog collar;  it looks pretty fancy with its blue leather strap studded with silver and a golden buckle.

>n
Cellar
It is cold and damp here, there is just enough light coming from the room above to see that you are in a stone-walled cellar with exits to the north and south.  An odd fungus is growing all around.  This place looks ancient, possibly unused for centuries.

Ralph arrives from the south.

>n
Old Storage Area
The stone-walled tunnel ends here, in what looks like an old storage area, based on the rotting crates lying about.

There are some ancient storage crates here.

Ralph arrives from the south.

>x crates
Made from the wood of trees that have long since died or were chopped down.  You think even a sneeze could destroy them.

>showme
Old Storage Area - room
    Ralph - wolf
        blue collar (worn)
    yourself - person
        glowing fungus
        green fungus
    rotting crates

>stand on crates
They crumble to dust and your barest touch.

>l
Old Storage Area
The stone-walled tunnel end here, in this now empty old storage area.

Ralph is here beside you, ready to follow your lead.

>eat glowing
You plop the glowing fungus into your mouth, chew, and swallow.  Not too bad, surprisingly.

"That certainly wasn't your brightest idea," Ralph quips.

It is now pitch dark in here!

>undo
Old Storage Area
[Previous turn undone.]

>l
Old Storage Area
The stone-walled tunnel end here, in this now empty old storage area.

Ralph is here beside you, ready to follow your lead.

>s
Cellar
It is cold and damp here, there is just enough light coming from the room above to see that you are in a stone-walled cellar with exits to the north and south.  An odd fungus is growing all around.  This place looks ancient, possibly unused for centuries.

Ralph arrives from the north.

>s
Cave-In
Cave-In description.

Ralph arrives from the north.

* * *

>push lump. push rug. open door. down.
Looking closer at the lump, you realize it is your best friend Ralph curled up asleep!  You wake him up and he slowly comes around.
"Thank you, Teacup!" Ralph says. "What happened to us?  I don't remember anything."

Your snouts wrinkling in disgust, with Ralph's help you manage to slide the rug off to one side, leaving a trail of dirt and revealing a trap door in the floor!

You and Ralph put your backs into and apply all of your combined canine power.  There is a loud snapping sound as rusted metal and old wood give way, causing the door to fly open and you and Ralph to tumble over backwards.
The trap door is now open!

Cellar
It is cold and damp here, there is just enough light coming from the room above to see that you are in a stone-walled cellar with exits to the north and south.  An odd fungus is growing all around.  There's something about this place that tells you it is old...very old.

Ralph arrives from above.

>get fungus
You scrap some of the stuff from a crack between two stones on a wall.  It looks greenish and unhealthy.

>s
Darkness
It is pitch dark, and you can't see a thing.

>wait
Time passes.

>g
Time passes.

>g
Time passes.

>get peanut
You can't see any such thing.

>n
Cellar
It is cold and damp here, there is just enough light coming from the room above to see that you are in a stone-walled cellar with exits to the north and south.  An odd fungus is growing all around.  There's something about this place that tells you it is old...very old.

Ralph arrives from the south.

>i
You are carrying:
  a green fungus

>throw fungus at ralph
(the green fungus at Ralph)
 Boo hoo!

>i
You are carrying nothing.

>l
Cellar
It is cold and damp here, there is just enough light coming from the room above to see that you are in a stone-walled cellar with exits to the north and south.  An odd fungus is growing all around.  There's something about this place that tells you it is old...very old.

Ralph is here beside you, ready to follow your lead.

You can also see a green fungus here.

>get green fungus
Taken.

>throw green fungus at ralph
 Like a furball ninja, Ralph easily dodges the green fungus, where it falls harmlessly to the ground.

>get green. throw green at ralph
Taken.

 Lamer!

>g
(first taking the green fungus)
 Boo hoo!

>g
(first taking the green fungus)
 Lamer!

>g
(first taking the green fungus)
 Boo hoo!

>g
(first taking the green fungus)
 Quit it, fagbag!

>g
(first taking the green fungus)
 Boo hoo!

>g
(first taking the green fungus)
 Like a furball ninja, Ralph easily dodges the green fungus, where it falls harmlessly to the ground.

>g
(first taking the green fungus)
 Quit it, fagbag!