You are Teacup, an unusually bright and clever fox from Foxtown.  Get ready for your next adventure!

The Adventures of Teacup
Story time for Teira by Robert Haddon
Release 0 / Serial number 140302 / Inform 7 build 6G60 (I6/v6.32 lib 6/12N) SD

You groan and rub open your eyes with both paws.   You discover that you are lying near a warm and furry lump in the corner of a strange room.  You have no idea how you got here or even where "here" is.

Your last memory is of  Ralph and you starting an investigation at an old building at the edge of Foxtown.  Speaking of Ralph, where is he?

You stand up and brush yourself off.  Satisfied that you have no broken bones or open wounds, it's time to find Ralph and figure out what's happening!

>l rug
An oval-shaped rug, woven from some sort of fibers.  It looks a bit out of place in the room.

A low, muffled sound is coming from the lump.

* * *

>push lump
Looking closer at the lump, you realize it is your best friend Ralph curled up asleep!  You wake him up and he slowly comes around.
"Thank you, Teacup!" Ralph says. "What happened to us?  I don't remember anything."

* * *

>x slime
It's green, it's slimey, it looks nasty, and it smells worse.  However, if you really wanted to, it looks like it can be removed from the cellar stones.

>get slime
You scrape some of the stuff from between various cracks on the walls until you have enough to hold onto.  It looks greenish and unhealthy.

>x slime
TODO  it looks plantable.

>x putrid
TODO  it looks plantable.

* * *

>get fungus
You can't see any such thing.

>north
Old Storage Area
The stone-walled tunnel ends here, in what looks like an old storage area, based on the rotting crates lying about.

A glowing mushroom is here.

There are some moldy wooden storage crates here.

Ralph arrives from the south.

>get glowing mushroom
You pull the glowing mushroom out of the ground and notice that it is not quite as bright as it used to be.

* * *

>south
Before you can leave, Ralph grabs your shoulder. "Teacup, listen!  Can you hear that?  Let's get out of here, now!"
You shrug your haunches and continue anyway. "What choice do we have?" You ask.

Cave-In
It is hard to say how far south the old stone-walled tunnel once led, because at the south end of the room the roof has collapsed, making the way now impassible.  

The ground is shifting under your paws and your hackles are rising:  you sense danger here!

You can see a peanut here.

Ralph arrives from the north.

>get peanut
Taken.

Boooooom!!!
The whole room begins to shake violently!  You can't tell if it is an earthquake or if a bomb has gone off somewhere near by, but you have no time to think about it as the floor on which you and Ralph are standing suddenly collapses!  You slip off your feet and tumble into a huge crack that has opened underneath you.

During your tumble, you dropped everything you were carrying!

Thick dust is falling everywhere,  preventing you from seeing anything at the moment.

Darkness
It is pitch dark, and you can't see a thing.

The glowing mushroom seems to be getting dimmer.

>z
Time passes.

The dust finally settles enough for you to see where you are.

Dining Hall
This is an elloborately decorated room with rich wood paneling on the walls and a large wooden table in the middle surrounded by fancy chairs.  The west end of the room is a mess of debris from the recent disaster, covering half the table and some of the chairs.  Hanging from the ceiling is an iron chandalier, providing light. There is a doorway to the north and a tunnel leading east.  On the west wall hangs a large tapestry.

Ralph is here beside you, ready to follow your lead.

A glowing mushroom is here.

You can also see a peanut here.

>get all
glowing mushroom: Taken.
peanut: Taken.

* * *

>n
Kitchen
You are in a medium-sized room that looks like it served as a kitchen in ages past.  It has been cleaned out.

A serving spoon is on the ground here, missed by whomever cleaned out the kitchen.

Ralph arrives from the south.

>get spoon
Taken.

Your glowing mushroom is definitely getting darker!  Perhaps you can find another one or somehow replant this one?

"That's not good," Ralph worries.

>s
Dining Hall
This is an elloborately decorated room with rich wood paneling on the walls and a large wooden table in the middle surrounded by fancy chairs.  The west end of the room is a mess of debris from the recent disaster, covering half the table and some of the chairs.  Hanging from the ceiling is an iron chandalier, providing light. There is a doorway to the north and a tunnel leading east.  On the west wall hangs a large tapestry.

Ralph arrives from the north.

>e
Underground Park
This is a large open area stretching out in all directions as far as you can see, covered with grassy rolling hills and shallow valleys.  High above you is a bright ceiling, as if painted in light.  At the far end of this area you can see a gray rocky outcrop rising above the sea of green grass.  A trail through the grass leads off to the east.

There is a large sign here.

"Woah!" you exclaim, wondering at the magic that allows grass to grow underground like this.

Ralph arrives from the west.

>x sign
The sign looks like the official kind you find in public parks.  The posts are rotting and the paint is chipped and worn, but you can make out some letters:
     Ra bitvill  P rk
     Magi al Growin  rea

>e
Abandoned Zoo
Here you see silver cages on display, resting on raised platforms.  It looks like some sort of zoo.  Whatever creatures were here died long ago, because there are only bones in the cages now.  To the west you can see the grassy area, and on the north wall there is a doorway.

There are cages here, in which you can see some bones.

You can also see an office door here.

Ralph arrives from the west.

Oh no!  The mushroom is barely glowing at all now!

"We need to do something, Teacup!" Ralph warns.

>get bones
The silver cages aren't open.

>n
(first opening the office door)

Zoo Office
Office of the Zoo.  There are no exits except the one you arrived by, to the south.  In one corner of the room stands an official looking desk.

There is a desk here, perhaps once used for Zoo business.

On the office desk is a cage key.

You can also see an office door and a control panel here.

Ralph arrives from the south.

* * *

>unlock cage
What do you want to unlock the cage key with?

>unlock cages with silver
(first taking the silver cages)
Those don't seem to fit the lock.

>unlock silver cages with cage key
You unlock the silver cages and can now get to the bones, if you wish.

The glowing mushroom has gone out!

>get bones
The silver cages aren't open.

* * *

>get bones
Taken.

>w
Underground Park
This is a large open area stretching out in all directions as far as you can see, covered with grassy rolling hills and shallow valleys.  High above you is a bright ceiling, as if painted in light.  At the far end of this area you can see a gray rocky outcrop rising above the sea of green grass.  A trail through the grass leads off to the east.

There is a large sign here.

Ralph arrives from the east.

>plant glowing with spoon
Like real farmer, you create a tidy hole in the ground with the serving spoon and carefully put the glowing mushroom inside.

"I'm not a gardener, Teacup, but I think fungi like the glowing mushroom only grow in the dark." Ralph tells you.

>e
Abandoned Zoo
Here you see silver cages on display, resting on raised platforms.  It looks like some sort of zoo.  Whatever creatures were here died long ago, because there are only bones in the cages now.  To the west you can see the grassy area, and on the north wall there is a doorway.

You can see an office door here.

Ralph arrives from the west.

"Maybe there's a way to turn off the lights in the park?" Ralph suggests hopefully.

>n
Zoo Office
Office of the Zoo.  There are no exits except the one you arrived by, to the south.  In one corner of the room stands an official looking desk.

There is a desk here, perhaps once used for Zoo business.

You can also see an office door and a control panel here.

Ralph arrives from the south.

Ralph mutters to himself, something about "darkness".

>x panel
The control panel has a green button.

Ralph continues to mutter.

>push button
Click.

"That should help the glowing mushroom grow," Ralph tells you.

>s
Abandoned Zoo
Here you see silver cages on display, resting on raised platforms.  It looks like some sort of zoo.  Whatever creatures were here died long ago, because there are only bones in the cages now.  To the west you can see the grassy area, and on the north wall there is a doorway.

You can see an office door here.

Ralph arrives from the north.

>w
Darkness
It is pitch dark, and you can't see a thing.

Underground Park
This is a large open area stretching out in all directions as far as you can see, covered with grassy rolling hills and shallow valleys.  High above you is a bright ceiling, as if painted in light.  At the far end of this area you can see a gray rocky outcrop rising above the sea of green grass.  A trail through the grass leads off to the east.

Ralph is here beside you, ready to follow your lead.

A glowing mushroom is planted here; it looks full grown now.

There is a large sign here.

>x glowing
The glowing mushroom is planted in the ground; there's not much to see.

>get glowing
When you harvest the glowing mushroom, it seems brighter than before.

>x outcrop
Rocks larger than yourself and stacked here, one atop the other.  They look climbable.

>climb rocks
Using the provided steps, you carefully scramble upwards.

Ledge
You have reached a small flat area atop the rocks, with a bit of soil and a sapling.  From up here you have an amazing view of the vast and beautiful grassland below you.

A spry young oak sapling is growing in the dirt here.

Ralph arrives from below.

>x sapling
It looks very similar to the saplings that you see when you play Minecraft.

>crush bone
You find a hard surface to rest the bones against, then grind and smash them until you create a fine powdery dust.

>x meal
The bone meal is a fine white powder in a neat little triangular pile, briming with potential.

>put meal on sapling
You fertilize the oak sapling with the bone meal.  For a moment nothing happens, and then right before your eyes the sapling begins to grow rapidly, stretching above you towards the roof.

Crunch!

The growing oak smashed right through the roof of the park! You can see sunlight streaming through the hole.
The tree seems to have stopped growing and now looks climbable to you.

>u
You scramble from branch to branch until you make it through the hole near the hole near the top of the tree.

You are momentarily blinded by the bright afternoon light, but as your eyes adjust, familiar shapes start to come into focus.  Amazingly, and for the first time in what seems a very long while, you actually recognize where you are!

Outskirts of Fox Town
After so long in the dark, the warmth of the sun feels really good on your fur.  You are in a clearing with heavy woods all around you, except toward the west where you see a damaged building at the edge of Fox Town.

Ralph says "Teacup!  I remember this place now!"  He points one sharp claw towards the west: "There's the building we were sent to investigate!"

>w
With tired paws, you begin the short walk over to the damaged-looking building.
Ralph says "There's somebody waving to us over there!"

Destroyed Building
Rumbled crumbled.

You can see Blotz McDoogle here.

Blotz McDoogle is an older fox with gray fur who is rather large around the middle.  Before noticing you, he was looking terribly upset and was wringing his paws together in agitation.  But at first sight of you, his snout grew an enormous grin and he started bouncing up and down in happiness.

"Teacup!  I'm so happy you're okay!" Blotz McDoogle exclaims.  "When I couldn't find you after the earthquake, I cursed my foul luck in asking you and Ralph to search for my lost peanut.

"But speaking of Ralph, where is he?  Didn't he make it out with you?"

Blotz McDoogle is trying to make peanut shapes with his paws
Ralph arrives from the giant tree.

"Ah, there you are Ralphie boy!" beamed Blotz happily.  "You had me worried for a moment."

"So, now that I know you two are alright, might I ask if you managed to find my peanut?" asks Blotz.  "It's ever so important to me."

>undo
Outskirts of Fox Town
[Previous turn undone.]

>rules
Rules tracing now switched on. Type "rules off" to switch it off again, or "rules all" to include even rules which do not apply.

* * *

>e
[Rule "standard set going variables rule" applies.]
[Rule "can't travel in what's not a vehicle rule" applies.]
[Rule "can't go through undescribed doors rule" applies.]
[Rule "can't go through closed doors rule" applies.]
[Rule "determine map connection rule" applies.]
[Rule "can't go that way rule" applies.]
[Rule "move player and vehicle rule" applies.]
[Rule "move floating objects rule" applies.]
[Rule "check light in new location rule" applies.]
[Rule "describe room gone into rule" applies.]

[Rule "determine visibility ceiling rule" applies.]
[Rule "room description heading rule" applies.]
Outskirts of Fox Town
[Rule "room description body text rule" applies.]
After so long in the dark, the warmth of the sun feels really good on your fur.  You are in a clearing with heavy woods all around you, except toward the west where you see a damaged building at the edge of Fox Town.

[Rule "room description paragraphs about objects rule" applies.]
[Rule "don't mention player's supporter in room descriptions rule" applies.]
[Rule "don't mention scenery in room descriptions rule" applies.]
[Rule "don't mention undescribed items in room descriptions rule" applies.]
[Rule "set pronouns from items in room descriptions rule" applies.]
[Rule "offer items to writing a paragraph about rule" applies.]
[Rule "use initial appearance in room descriptions rule" applies.]
[Rule "describe what's on scenery supporters in room descriptions rule" applies.]
[Rule "check new arrival rule" applies.]
[Rule "other people looking rule" applies.]
[Rule "Every turn when Meeting Blotz is happening" applies.]
[Rule "standard set going variables rule" applies.]
[Rule "can't travel in what's not a vehicle rule" applies.]
[Rule "can't go through undescribed doors rule" applies.]
[Rule "can't go through closed doors rule" applies.]
[Rule "determine map connection rule" applies.]
[Rule "can't go that way rule" applies.]
[Rule "move player and vehicle rule" applies.]
[Rule "move floating objects rule" applies.]
[Rule "check light in new location rule" applies.]
[Rule "describe room gone into rule" applies.]
Ralph arrives from the west.

>w
[Rule "standard set going variables rule" applies.]
[Rule "Instead of the player going to the Destroyed Building" applies.]
[Rule "can't travel in what's not a vehicle rule" applies.]
[Rule "can't go through undescribed doors rule" applies.]
[Rule "can't go through closed doors rule" applies.]
[Rule "determine map connection rule" applies.]
[Rule "can't go that way rule" applies.]
[Rule "move player and vehicle rule" applies.]
[Rule "move floating objects rule" applies.]
[Rule "check light in new location rule" applies.]
[Rule "describe room gone into rule" applies.]

[Rule "determine visibility ceiling rule" applies.]
[Rule "room description heading rule" applies.]
Destroyed Building
[Rule "room description body text rule" applies.]
Rumbled crumbled.

[Rule "room description paragraphs about objects rule" applies.]
[Rule "don't mention player's supporter in room descriptions rule" applies.]
[Rule "don't mention scenery in room descriptions rule" applies.]
[Rule "don't mention undescribed items in room descriptions rule" applies.]
[Rule "set pronouns from items in room descriptions rule" applies.]
[Rule "offer items to writing a paragraph about rule" applies.]
[Rule "use initial appearance in room descriptions rule" applies.]
[Rule "describe what's on scenery supporters in room descriptions rule" applies.]
[Rule "don't mention player's supporter in room descriptions rule" applies.]
[Rule "don't mention scenery in room descriptions rule" applies.]
[Rule "don't mention undescribed items in room descriptions rule" applies.]
[Rule "set pronouns from items in room descriptions rule" applies.]
[Rule "offer items to writing a paragraph about rule" applies.]
[Rule "use initial appearance in room descriptions rule" applies.]
[Rule "describe what's on scenery supporters in room descriptions rule" applies.]
You can see Blotz McDoogle here.

[Rule "check new arrival rule" applies.]
[Rule "other people looking rule" applies.]
[Rule "Every turn when Meeting Blotz is happening" applies.]
[Rule "standard set going variables rule" applies.]
[Rule "can't travel in what's not a vehicle rule" applies.]
[Rule "can't go through undescribed doors rule" applies.]
[Rule "can't go through closed doors rule" applies.]
[Rule "determine map connection rule" applies.]
[Rule "can't go that way rule" applies.]
[Rule "move player and vehicle rule" applies.]
[Rule "move floating objects rule" applies.]
[Rule "check light in new location rule" applies.]
[Rule "describe room gone into rule" applies.]
Ralph arrives from the east.

* * *

>i
You are carrying:
  some bone meal
  some silver cages (open but empty)
  a serving spoon
  a peanut

Ralph is carrying the blue collar.

>x blotz
Blotz McDoogle is an elderly fox who is rather plump.  You remember that he is a friend of your father's and he hired you to retrieve a peanut.  Probably one of the silliest cases you and Ralph have ever taken.

Blotz McDoogle is looking hopefully at you.

>give peanut to Blotz
push lump

* * *

>l
Destroyed Building
Rumbled crumbled.

Ralph is here beside you, ready to follow your lead.

You can also see Blotz McDoogle here.

Blotz McDoogle is drawing peanuts in the dirt with his toe claws.

>scenes
Scene 'Entire Game' playing (for 45 mins now)
Scene 'Starting Out' ended
Scene 'Earthquake' ended
Scene 'Settling Dust' ended
Scene 'Sunshine' playing (for 4 mins now)
Scene 'Meeting Blotz' ended
Scene 'Chatty Blotz' playing (for 2 mins now)
(Scene monitoring now switched on. Type "scenes off" to switch it off again.)

>x
What do you want to examine?

>i
You are carrying:
  some bone meal
  some silver cages (open but empty)
  a serving spoon
  a peanut

Ralph is carrying the blue collar.

Blotz McDoogle is looking hopefully at you.

>talk to Blotz
"You found my peanut, right?  Please tell me you found it!" Blotz McDoogle urges.

Blotz McDoogle says "So, about that peanut...?"

>talk to Blotz
"P. E. A. N. U. T." Blotz spells out.

Blotz McDoogle is drawing peanuts in the dirt with his toe claws.

>tell ralph about peanut
This provokes no reaction.

Blotz McDoogle says "I can't wait to hear about my peanut!"

>tell blotz about secret note
Feeling more than a bit ashamed, you tell Blotz about how you and Ralph smashed the peanut and found the secret note inside.
Blotz McDoogle, looking only a little upset, says "Well, I guess learning the secret code is good enough!  Thank you both for retrieving it for me.

    *** You have won ***

Would you like to RESTART, RESTORE a saved game, QUIT, or UNDO the last command?

>undo
Destroyed Building
[Previous turn undone.]

>tell blotz about slime
"I'm sure that's all very interesting, but what about my peanut?" replies Blotz.

Blotz McDoogle is drawing peanuts in the dirt with his toe claws.

>ask blotz about slime
Blotz replies "I'll answer any questions you might have after you tell me about the peanut!"

Blotz McDoogle says "It's quite possibly the most important peanut in the world!"

>talk to Blotz
"I want nutty news! McDoogle shouts.

Blotz McDoogle say "Please, tell me about the peanut."

>talk to McDoogle
"You found my peanut, right?  Please tell me you found it!" Blotz McDoogle urges.

Blotz McDoogle is looking hopefully at you.

>talk to mcdoogle
"I want nutty news! McDoogle shouts.

Blotz McDoogle say "Please, tell me about the peanut."

* * *

>l desk
It is an ordinary desk made of some light colored wood and is in very poor shape.

A low, muffled sound is coming from the lump.

* * *

>x drawer
It's just a drawer made of the same wood as the desk.  It looks openable.

A low, muffled sound is coming from the lump.

>l drawer
It's just a drawer made of the same wood as the desk.  It looks openable.

The lump looks strangely familiar to you now, and continues to make a low sound.

>d
You can't go that way.

The lump is nagging at your brain now, you should really check it out.

>gonear cellar
Cellar
It is cold and damp here, there is just enough light coming from the room above to see that you are in a cellar with cobblestone walls and exits to the north and south.  This place looks ancient, possibly unused for centuries.  Green slime drips from the cracks between stones.

Green slime grows between the stones.

>l
Cellar
It is cold and damp here, there is just enough light coming from the room above to see that you are in a cellar with cobblestone walls and exits to the north and south.  This place looks ancient, possibly unused for centuries.  Green slime drips from the cracks between stones.

Green slime grows between the stones.

The lump is nagging at your brain now, you should really check it out.

>x cobblestones
Old stones stacked expertly to form a solid wall, probably made by master masons hundreds of years ago, if not more.

The lump is nagging at your brain now, you should really check it out.

>status
That's not a verb I recognize.

>x stones
Old stones stacked expertly to form a solid wall, probably made by master masons hundreds of years ago, if not more.

The lump is nagging at your brain now, you should really check it out.

>x cobblestones
Old stones stacked expertly to form a solid wall, probably made by master masons hundreds of years ago, if not more.

The lump is nagging at your brain now, you should really check it out.

>x cracks
Old stones stacked expertly to form a solid wall, probably made by master masons hundreds of years ago, if not more.

The lump is nagging at your brain now, you should really check it out.

>x stones
Old stones stacked expertly to form a solid wall, probably made by master masons hundreds of years ago, if not more.

The lump is nagging at your brain now, you should really check it out.

>climb stones
I don't think much is to be achieved by that.

The lump is nagging at your brain now, you should really check it out.

>gonear abandoned zoo
Abandoned Zoo
Here you see silver cages on display, resting on raised platforms.  It looks like some sort of zoo.  Whatever creatures were here died long ago, because there are only bones in the cages now.  To the west you can see the grassy area, and on the north wall there is a doorway.

There are cages here, in which you can see some bones.

You can also see an office door here.

>x cages
All the cages have plaques with writing on them.  You read some of them:
    Coyote
    Fox
    Wolf
With mounting horror, you stop reading.  Now you know what the bones are from!

The lump is nagging at your brain now, you should really check it out.

>get cages
They're fixed in place.

The lump is nagging at your brain now, you should really check it out.

>gonear kitchen
Darkness
It is pitch dark, and you can't see a thing.

>purloin glowing mushroom
[Purloined.]

>l
The kitchen is plain, but large and once upon a time very functional.  You imagine that many large, fancy meals were once prepared here.

The lump is nagging at your brain now, you should really check it out.

The kitchen is plain, but large and once upon a time very functional.  You imagine that many large, fancy meals were once prepared here.

>s
Dining Hall
This is an elloborately decorated room with rich wood paneling on the walls and a large wooden table in the middle surrounded by fancy chairs.  The west end of the room is a mess of debris from the recent disaster, covering half the table and some of the chairs.  Hanging from the ceiling is an iron chandalier, providing light. There is a doorway to the north and a tunnel leading east.  On the west wall hangs a large tapestry.

The lump is nagging at your brain now, you should really check it out.

>l chandalier
It is a large band of iron suspended from the ceiling by fancy chains and holds several candles which light up the room.

The lump is nagging at your brain now, you should really check it out.

>x chair
The wooden chairs match the table and look like something you would find in a palace.

The lump is nagging at your brain now, you should really check it out.

>x chair
The wooden chairs match the table and look like something you would find in a palace.

The lump is nagging at your brain now, you should really check it out.

>x chairs
The wooden chairs match the table and look like something you would find in a palace.

The lump is nagging at your brain now, you should really check it out.

>gonear zoo office
Zoo Office
Office of the Zoo.  There are no exits except the one you arrived by, to the south.  In one corner of the room stands an official looking desk.

There is a desk here, perhaps once used for Zoo business.

On the office desk is a cage key.

You can also see an office door and a control panel here.

>x desk
It is an ordinary looking desk, made of metal painted gray.  It contains a small drawer.

On the office desk is a cage key.

The lump is nagging at your brain now, you should really check it out.

>open side drawer
You can't see any such thing.

>get key
Taken.

The lump is nagging at your brain now, you should really check it out.

>open side drawer with key
You can't see any such thing.

>open drawer
You open the small drawer, revealing a zoo record book.

The lump is nagging at your brain now, you should really check it out.

>x drawer
In the small drawer is a zoo record book.

The lump is nagging at your brain now, you should really check it out.

>open drawer
That's already open.

The lump is nagging at your brain now, you should really check it out.

>close drawer
You close the small drawer.

The lump is nagging at your brain now, you should really check it out.

>open side drawer
You can't see any such thing.