You are Teacup, an unusually bright and clever fox from Foxtown.  Get ready for your next adventure!

The Adventures of Teacup,
Story time for Teira by Robert Haddon
Release 0 / Serial number 140107 / Inform 7 build 6G60 (I6/v6.32 lib 6/12N) SD

You groan and rub open your eyes with both paws.   You discover that you are lying near a warm and furry lump in the corner of a strange room.  You have no idea how you got here or even where "here" is.

Your last memory is of  Ralph and you starting an investigation at an old building at the edge of Foxtown.  Speaking of Ralph, where is he?

You stand up and brush yourself off.  Satisfied that you have no broken bones or open wounds, it's time to find Ralph and figure out what's happening!

>push lump
Looking closer at the lump, you realize it is your best friend Ralph curled up asleep!  You wake him up and he slowly comes around.
"Thank you, Teacup!" Ralph says. "What happened to us?  I don't remember anything."

* * *

>south
Cellar
It is cold and damp here, there is just enough light coming from the room above to see that you are in a stone-walled cellar with exits to the north and south.  An odd fungus is growing all around.  This place looks ancient, possibly unused for centuries.

Ralph arrives from the north.

>south
Cave-In
It is hard to say how far south the old stone-walled tunnel once led, because at the south end of the room the roof has collapsed, making the way now impassible.  Your hackles are rising:  you sense danger here!

You can see a peanut here.

Ralph arrives from the north.

"Teacup, listen!  Can you hear that low rumbling sound?  Let's get out of here, now!" Ralph implores you.

>showme
Cave-In - room
    Ralph - wolf
        blue collar (worn)
    yourself - person
        glowing fungus
        green fungus
    peanut

>wait
Time passes.

Whammo!

You are with the bunnies!

Dining Hall

>wait
Time passes.

I beg your pardon?

I beg your pardon?

>wait
Time passes.

>wait
Time passes.

>l
Dining Hall

* * *

>south
Cave-In
It is hard to say how far south the old stone-walled tunnel once led, because at the south end of the room the roof has collapsed, making the way now impassible.  Your hackles are rising:  you sense danger here!

You can see a peanut here.

Ralph arrives from the north.

"Teacup, listen!  Can you hear that low rumbling sound?  Let's get out of here, now!" Ralph implores you.

>get peanut
Taken.

Boooooom!!!
The whole room begins to shake violently!  You can't tell if it is an earthquake or if a bomb has gone off somewhere near by, but you have no time to think about it as the floor on which you and Ralph are standing suddenly collapses!  You slip off your feet and tumble into a huge crack that has opened underneath you.

During your tumble, you dropped everything you were carrying!

Your ears are ringing and thick falling dust prevents you from seeing anything.

Darkness
It is pitch dark, and you can't see a thing.

>l
Darkness
It is pitch dark, and you can't see a thing.

settling dust pau
Dining Hall
This is an elloborately decorated room with rich wood paneling on the walls and a large wooden table in the middle surrounded by fancy chairs.  The west end of the room is a mess of debris from the recent disaster, covering half the table and some of the chairs.  There are doorways leading north and east.

Ralph is here beside you, ready to follow your lead.

You can also see a green fungus, a glowing fungus, and a peanut here.

>i
You are carrying nothing.

>x ralph
Ralph is a young wolf with light gray fur and wearing a blue collar.  He's been your friend and trusty companion with you on more adventures than you can count on with all four paws.

>x
What do you want to examine?

>x collar
This is no cheap PetSmart dog collar;  it looks pretty fancy with its blue leather strap studded with silver and a golden buckle.

>showme
Dining Hall - room
    green fungus
    glowing fungus
    peanut
    Ralph - wolf
        blue collar (worn)
    yourself - person

>get all
green fungus: Taken.
glowing fungus: Taken.
peanut: Taken.

* * *

>l
Darkness
It is pitch dark, and you can't see a thing.

settling dust pau
Dining Hall
This is an elloborately decorated room with rich wood paneling on the walls and a large wooden table in the middle surrounded by fancy chairs.  The west end of the room is a mess of debris from the recent disaster, covering half the table and some of the chairs.  There are doorways leading north and east.

Ralph is here beside you, ready to follow your lead.

You can also see a green fungus, a glowing fungus, and a peanut here.

>l
Dining Hall
This is an elloborately decorated room with rich wood paneling on the walls and a large wooden table in the middle surrounded by fancy chairs.  The west end of the room is a mess of debris from the recent disaster, covering half the table and some of the chairs.  There are doorways leading north and east.

Ralph is here beside you, ready to follow your lead.

You can also see a green fungus, a glowing fungus, and a peanut here.

>l
Dining Hall
This is an elloborately decorated room with rich wood paneling on the walls and a large wooden table in the middle surrounded by fancy chairs.  The west end of the room is a mess of debris from the recent disaster, covering half the table and some of the chairs.  There are doorways leading north and east.

Ralph is here beside you, ready to follow your lead.

You can also see a green fungus, a glowing fungus, and a peanut here.

>wait
Time passes.

* * *

>g
Time passes.

>l
Dining Hall
This is an elloborately decorated room with rich wood paneling on the walls and a large wooden table in the middle surrounded by fancy chairs.  The west end of the room is a mess of debris from the recent disaster, covering half the table and some of the chairs.  There are doorways leading north and east.

Ralph is here beside you, ready to follow your lead.

You can also see a green fungus, a glowing fungus, and a peanut here.

* * *

>get peanut
Taken.

Boooooom!!!
The whole room begins to shake violently!  You can't tell if it is an earthquake or if a bomb has gone off somewhere near by, but you have no time to think about it as the floor on which you and Ralph are standing suddenly collapses!  You slip off your feet and tumble into a huge crack that has opened underneath you.

During your tumble, you dropped everything you were carrying!

Your ears are ringing and thick falling dust prevents you from seeing anything.

Darkness
It is pitch dark, and you can't see a thing.

>i
You are carrying nothing.

The dust finally settles enough for you to see where you are.

Dining Hall
This is an elloborately decorated room with rich wood paneling on the walls and a large wooden table in the middle surrounded by fancy chairs.  The west end of the room is a mess of debris from the recent disaster, covering half the table and some of the chairs.  Hanging from the ceiling is an iron chandalier, providing light. There are doorways leading north and east.

Ralph is here beside you, ready to follow your lead.

You can also see a green fungus, a glowing fungus (providing light), and a peanut here.

>x chandalier
It is a large band of iron suspended from the ceiling by fancy chains and holds several candles which light up the room.

>get candles
They are way out of your reach, even if you stood on the table.

>stand on table
You get onto the Large Wooden Table.

I beg your pardon?

>go in table
But you're already on the Large Wooden Table.

>enter table
But you're already on the Large Wooden Table.

>stand
You get off the Large Wooden Table.

Dining Hall
This is an elloborately decorated room with rich wood paneling on the walls and a large wooden table in the middle surrounded by fancy chairs.  The west end of the room is a mess of debris from the recent disaster, covering half the table and some of the chairs.  Hanging from the ceiling is an iron chandalier, providing light. There are doorways leading north and east.

Ralph is here beside you, ready to follow your lead.

You can also see a green fungus, a glowing fungus (providing light), and a peanut here.

>sit
What do you want to sit on?

>sit on table
You get onto the Large Wooden Table.

I beg your pardon?

>stand
You get off the Large Wooden Table.

Dining Hall
This is an elloborately decorated room with rich wood paneling on the walls and a large wooden table in the middle surrounded by fancy chairs.  The west end of the room is a mess of debris from the recent disaster, covering half the table and some of the chairs.  Hanging from the ceiling is an iron chandalier, providing light. There are doorways leading north and east.

Ralph is here beside you, ready to follow your lead.

You can also see a green fungus, a glowing fungus (providing light), and a peanut here.

>stand on chair
You get onto the Wooden Chairs.

>stand on chairs
But you're already on the Wooden Chairs.

>s
(first getting off the Wooden Chairs)
You can't go that way.

>x table
It appears to be made of oak and looks fit to serve royalty.

>x chairs
The wooden chairs match the table and look like something you would find in a palace.

>x chair
The wooden chairs match the table and look like something you would find in a palace.

>stand
But you aren't in anything at the moment.

>n
Kitchen
Ralph arrives from the south.

>s
Dining Hall
This is an elloborately decorated room with rich wood paneling on the walls and a large wooden table in the middle surrounded by fancy chairs.  The west end of the room is a mess of debris from the recent disaster, covering half the table and some of the chairs.  Hanging from the ceiling is an iron chandalier, providing light. There are doorways leading north and east.

You can see a green fungus, a glowing fungus (providing light), and a peanut here.

Ralph arrives from the north.

>e
Grassy Room
Ralph arrives from the west.

>w
Dining Hall
This is an elloborately decorated room with rich wood paneling on the walls and a large wooden table in the middle surrounded by fancy chairs.  The west end of the room is a mess of debris from the recent disaster, covering half the table and some of the chairs.  Hanging from the ceiling is an iron chandalier, providing light. There are doorways leading north and east.

You can see a green fungus, a glowing fungus (providing light), and a peanut here.

Ralph arrives from the east.

* * *

>down
Cellar
It is cold and damp here, there is just enough light coming from the room above to see that you are in a stone-walled cellar with exits to the north and south.  An odd fungus is growing all around.  This place looks ancient, possibly unused for centuries.

Ralph arrives from above.

>get all
There are none at all available!

>get fungus
You scrap some of the stuff from a crack between two stones on a wall.  It looks greenish and unhealthy.

* * *

>north
Old Storage Area
The stone-walled tunnel ends here, in what looks like an old storage area, based on the rotting crates lying about.

There are some ancient storage crates here.

You can also see a glowing fungus (providing light) here.

Ralph arrives from the south.

>get all
rotting crates: They crumble to dust at the slightest touch.
glowing fungus: Taken.

>s
Cellar
It is cold and damp here, there is just enough light coming from the room above to see that you are in a stone-walled cellar with exits to the north and south.  An odd fungus is growing all around.  This place looks ancient, possibly unused for centuries.

Ralph arrives from the north.

>s
Cave-In
It is hard to say how far south the old stone-walled tunnel once led, because at the south end of the room the roof has collapsed, making the way now impassible.  Your hackles are rising:  you sense danger here!

You can see a peanut here.

Ralph arrives from the north.

"Teacup, listen!  Can you hear that low rumbling sound?  Let's get out of here, now!" Ralph implores you.

>l
Cave-In
It is hard to say how far south the old stone-walled tunnel once led, because at the south end of the room the roof has collapsed, making the way now impassible.  Your hackles are rising:  you sense danger here!

Ralph is here beside you, ready to follow your lead.

You can also see a peanut here.

>get peanut
Taken.

Boooooom!!!
The whole room begins to shake violently!  You can't tell if it is an earthquake or if a bomb has gone off somewhere near by, but you have no time to think about it as the floor on which you and Ralph are standing suddenly collapses!  You slip off your feet and tumble into a huge crack that has opened underneath you.

You are with the bunnies!

Dining Hall
During your tumble, you dropped the peanut, the glowing fungus, and the green fungus.

>l
Dining Hall

>i
You are carrying:
  a peanut
  a glowing fungus (providing light)
  a green fungus

* * *

>push lump
Looking closer at the lump, you realize it is your best friend Ralph curled up asleep!  You wake him up and he slowly comes around.
"Thank you, Teacup!" Ralph says. "What happened to us?  I don't remember anything."

>l
You stand up and brush yourself off.  Satisfied with your appearance, you inspect your surroundings.

Small Room
This is a small room with no windows.  It is dimly lit from a grubby ceiling lamp high above your head and shines down on a dirty rug in the middle of the floor.  A doorway to the east is completely filled with a pile of rubble.

Ralph is here beside you, ready to follow your lead.

A dirty rug lies in the center of the room.  It's horrible looking and probably much worse to touch.  It looks quite thick and heavy, though with some help you could probably move it.

A rickety wooden desk with a single drawer sits in the northwest corner of the room.

* * *

>push lump.
Looking closer at the lump, you realize it is your best friend Ralph curled up asleep!  You wake him up and he slowly comes around.
"Thank you, Teacup!" Ralph says. "What happened to us?  I don't remember anything."

>push rug
Your snouts wrinkling in disgust, with Ralph's help you manage to slide the rug off to one side, leaving a trail of dirt and revealing a trap door in the floor!

* * *

>get fungus
You scrap some of the stuff from a crack between two stones on a wall.  It looks greenish and unhealthy.

>eat fungus
(the green fungus)

    *** Didn't your parents ever warn you about eating unknown fungi?  You should have listened to them more carefully, because your experience with eating the green fungus does not go well.

The horrible taste of the stuff was not the worst part.  The hours of painful stomach cramps and hallucinations also were not the worst part.  The worst part was definitely when your head melted and you died.

Ralph was smart enough not to eat the green fungus, but not smart enough to escape this place without your help.  So he died a few days after you did, lonely and miserable. ***

Would you like to RESTART, RESTORE a saved game, QUIT, or UNDO the last command?

>listen
Please give one of the answers above.

Would you like to RESTART, RESTORE a saved game, QUIT, or UNDO the last command?

>s
Please give one of the answers above.

Would you like to RESTART, RESTORE a saved game, QUIT, or UNDO the last command?

>eat fungus
Please give one of the answers above.

Would you like to RESTART, RESTORE a saved game, QUIT, or UNDO the last command?

>restart
You are Teacup, an unusually bright and clever fox from Foxtown.  Get ready for your next adventure!

The Adventures of Teacup,
Story time for Teira by Robert Haddon
Release 0 / Serial number 140107 / Inform 7 build 6G60 (I6/v6.32 lib 6/12N) SD

You groan and rub open your eyes with both paws.   You discover that you are lying near a warm and furry lump in the corner of a strange room.  You have no idea how you got here or even where "here" is.

Your last memory is of  Ralph and you starting an investigation at an old building at the edge of Foxtown.  Speaking of Ralph, where is he?

You stand up and brush yourself off.  Satisfied that you have no broken bones or open wounds, it's time to find Ralph and figure out what's happening!

>push lump
Looking closer at the lump, you realize it is your best friend Ralph curled up asleep!  You wake him up and he slowly comes around.
"Thank you, Teacup!" Ralph says. "What happened to us?  I don't remember anything."

* * *

>down
Cellar
It is cold and damp here, there is just enough light coming from the room above to see that you are in a stone-walled cellar with exits to the north and south.  An odd fungus is growing all around.  This place looks ancient, possibly unused for centuries.

Ralph arrives from above.

>sout
That's not a verb I recognize.

>s
Darkness
It is pitch dark, and you can't see a thing.

"Teacup, listen!  Can you hear that low rumbling sound?  Let's get out of here, now!" Ralph implores you.

>wait
Time passes.

>get peanut
You can't see any such thing.

>north
Cellar
It is cold and damp here, there is just enough light coming from the room above to see that you are in a stone-walled cellar with exits to the north and south.  An odd fungus is growing all around.  This place looks ancient, possibly unused for centuries.

Ralph arrives from the south.

>north
Old Storage Area
The stone-walled tunnel ends here, in what looks like an old storage area, based on the rotting crates lying about.

There are some ancient storage crates here.

You can also see a glowing fungus (providing light) here.

Ralph arrives from the south.

>get glowing
Taken.

>s
Cellar
It is cold and damp here, there is just enough light coming from the room above to see that you are in a stone-walled cellar with exits to the north and south.  An odd fungus is growing all around.  This place looks ancient, possibly unused for centuries.

Ralph arrives from the north.

>s
Cave-In
It is hard to say how far south the old stone-walled tunnel once led, because at the south end of the room the roof has collapsed, making the way now impassible.  Your hackles are rising:  you sense danger here!

You can see a peanut here.

Ralph arrives from the north.

>get peanut
Taken.

Boooooom!!!
The whole room begins to shake violently!  You can't tell if it is an earthquake or if a bomb has gone off somewhere near by, but you have no time to think about it as the floor on which you and Ralph are standing suddenly collapses!  You slip off your feet and tumble into a huge crack that has opened underneath you.

You are with the bunnies!

Dining Hall
This is an elloborately decorated room with rich wood paneling on the walls and a large wooden table in the middle surrounded by fancy chairs.  The west end of the room is a mess of debris from the recent disaster, covering half the table and some of the chairs.  There are doorways leading north and east.

During your tumble, you dropped peanut and glowing fungus.

>l
Dining Hall
This is an elloborately decorated room with rich wood paneling on the walls and a large wooden table in the middle surrounded by fancy chairs.  The west end of the room is a mess of debris from the recent disaster, covering half the table and some of the chairs.  There are doorways leading north and east.

Ralph is here beside you, ready to follow your lead.

You can also see a glowing fungus and a peanut here.

* * *

>l
You stand up and brush yourself off.  Satisfied with your appearance, you inspect your surroundings.

Small Room
This is a small room with no windows.  It is dimly lit from a grubby ceiling lamp high above your head and shines down on a dirty rug in the middle of the floor.  A doorway to the east is completely filled with a pile of rubble.

A dirty rug lies in the center of the room.  It's horrible looking and probably much worse to touch.  It looks quite thick and heavy, though with some help you could probably move it.

A rickety wooden desk with a single drawer sits in the northwest corner of the room.

The lump that you were lying near is here, moving up and down very slightly.  It might be alive!

A low, muffled sound is coming from the lump.

>l
Small Room
This is a small room with no windows.  It is dimly lit from a grubby ceiling lamp high above your head and shines down on a dirty rug in the middle of the floor.  A doorway to the east is completely filled with a pile of rubble.

A dirty rug lies in the center of the room.  It's horrible looking and probably much worse to touch.  It looks quite thick and heavy, though with some help you could probably move it.

A rickety wooden desk with a single drawer sits in the northwest corner of the room.

The lump that you were lying near is here, moving up and down very slightly.  It might be alive!

The lump looks strangely familiar to you now, and continues to make a low sound.